"","Date","fullname","site","station","sensor","max","min","avg","amp"
"1",2024-06-01,"SSMH-SA","SSMH","SA","21398622",698,13,355.5,685
"2",2024-06-01,"SSMH-SB","SSMH","SB","21362319",587,9,298,578
"3",2024-06-01,"SSMH-SI","SSMH","SI","21398619",491,17,254,474
"4",2024-06-01,"TNHA-BASE","TNHA","BASE","21176526",648,14,331,634
"5",2024-06-01,"TNHA-SA","TNHA","SA","21398620",799,7,403,792
"6",2024-06-01,"TNHA-SB","TNHA","SB","21362318",568,18,293,550
"7",2024-06-01,"TNHA-SD","TNHA","SD","21362315",373,9,191,364
"8",2024-06-02,"SSMH-SA","SSMH","SA","21398622",372,2,187,370
"9",2024-06-02,"SSMH-SB","SSMH","SB","21362319",318,1,159.5,317
"10",2024-06-02,"SSMH-SI","SSMH","SI","21398619",278,2,140,276
"11",2024-06-02,"TNHA-BASE","TNHA","BASE","21176526",371,2,186.5,369
"12",2024-06-02,"TNHA-SA","TNHA","SA","21398620",342,1,171.5,341
"13",2024-06-02,"TNHA-SB","TNHA","SB","21362318",389,2,195.5,387
"14",2024-06-02,"TNHA-SD","TNHA","SD","21362315",202,1,101.5,201
"15",2024-06-03,"SSMH-SA","SSMH","SA","21398622",242,9,125.5,233
"16",2024-06-03,"SSMH-SB","SSMH","SB","21362319",167,7,87,160
"17",2024-06-03,"SSMH-SI","SSMH","SI","21398619",232,9,120.5,223
"18",2024-06-03,"TNHA-BASE","TNHA","BASE","21176526",358,11,184.5,347
"19",2024-06-03,"TNHA-SA","TNHA","SA","21398620",151,4,77.5,147
"20",2024-06-03,"TNHA-SB","TNHA","SB","21362318",278,12,145,266
"21",2024-06-03,"TNHA-SD","TNHA","SD","21362315",169,6,87.5,163
"22",2024-06-04,"SSMH-SA","SSMH","SA","21398622",233,13,123,220
"23",2024-06-04,"SSMH-SB","SSMH","SB","21362319",174,8,91,166
"24",2024-06-04,"SSMH-SI","SSMH","SI","21398619",214,13,113.5,201
"25",2024-06-04,"TNHA-BASE","TNHA","BASE","21176526",243,11,127,232
"26",2024-06-04,"TNHA-SA","TNHA","SA","21398620",159,8,83.5,151
"27",2024-06-04,"TNHA-SB","TNHA","SB","21362318",277,14,145.5,263
"28",2024-06-04,"TNHA-SD","TNHA","SD","21362315",153,8,80.5,145
"29",2024-06-05,"SSMH-SA","SSMH","SA","21398622",424,9,216.5,415
"30",2024-06-05,"SSMH-SB","SSMH","SB","21362319",279,6,142.5,273
"31",2024-06-05,"SSMH-SI","SSMH","SI","21398619",343,8,175.5,335
"32",2024-06-05,"TNHA-BASE","TNHA","BASE","21176526",446,8,227,438
"33",2024-06-05,"TNHA-SA","TNHA","SA","21398620",359,4,181.5,355
"34",2024-06-05,"TNHA-SB","TNHA","SB","21362318",451,9,230,442
"35",2024-06-05,"TNHA-SD","TNHA","SD","21362315",331,6,168.5,325
"36",2024-06-06,"SSMH-SA","SSMH","SA","21398622",516,9,262.5,507
"37",2024-06-06,"SSMH-SB","SSMH","SB","21362319",432,7,219.5,425
"38",2024-06-06,"SSMH-SI","SSMH","SI","21398619",278,9,143.5,269
"39",2024-06-06,"TNHA-BASE","TNHA","BASE","21176526",494,12,253,482
"40",2024-06-06,"TNHA-SA","TNHA","SA","21398620",563,4,283.5,559
"41",2024-06-06,"TNHA-SB","TNHA","SB","21362318",482,12,247,470
"42",2024-06-06,"TNHA-SC","TNHA","SC","21362317",189,181,185,8
"43",2024-06-06,"TNHA-SD","TNHA","SD","21362315",209,6,107.5,203
"44",2024-06-07,"SSMH-SA","SSMH","SA","21398622",539,9,274,530
"45",2024-06-07,"SSMH-SB","SSMH","SB","21362319",394,7,200.5,387
"46",2024-06-07,"SSMH-SI","SSMH","SI","21398619",272,9,140.5,263
"47",2024-06-07,"TNHA-BASE","TNHA","BASE","21176526",539,12,275.5,527
"48",2024-06-07,"TNHA-SA","TNHA","SA","21398620",403,4,203.5,399
"49",2024-06-07,"TNHA-SB","TNHA","SB","21362318",407,11,209,396
"50",2024-06-07,"TNHA-SC","TNHA","SC","21362317",187,7,97,180
"51",2024-06-07,"TNHA-SD","TNHA","SD","21362315",362,6,184,356
"52",2024-06-08,"SSMH-BASE","SSMH","BASE","21390413",858,391,624.5,467
"53",2024-06-08,"SSMH-SA","SSMH","SA","21398622",696,21,358.5,675
"54",2024-06-08,"SSMH-SB","SSMH","SB","21362319",561,14,287.5,547
"55",2024-06-08,"SSMH-SI","SSMH","SI","21398619",594,22,308,572
"56",2024-06-08,"TNHA-BASE","TNHA","BASE","21176526",666,24,345,642
"57",2024-06-08,"TNHA-SA","TNHA","SA","21398620",784,12,398,772
"58",2024-06-08,"TNHA-SB","TNHA","SB","21362318",588,29,308.5,559
"59",2024-06-08,"TNHA-SC","TNHA","SC","21362317",186,24,105,162
"60",2024-06-08,"TNHA-SD","TNHA","SD","21362315",758,16,387,742
"61",2024-06-09,"SSMH-BASE","SSMH","BASE","21390413",564,9,286.5,555
"62",2024-06-09,"SSMH-SA","SSMH","SA","21398622",642,13,327.5,629
"63",2024-06-09,"SSMH-SB","SSMH","SB","21362319",492,9,250.5,483
"64",2024-06-09,"SSMH-SI","SSMH","SI","21398619",413,17,215,396
"65",2024-06-09,"TNHA-BASE","TNHA","BASE","21176526",608,12,310,596
"66",2024-06-09,"TNHA-SA","TNHA","SA","21398620",777,6,391.5,771
"67",2024-06-09,"TNHA-SB","TNHA","SB","21362318",558,22,290,536
"68",2024-06-09,"TNHA-SC","TNHA","SC","21362317",411,17,214,394
"69",2024-06-09,"TNHA-SD","TNHA","SD","21362315",251,8,129.5,243
"70",2024-06-10,"SSMH-BASE","SSMH","BASE","21390413",849,9,429,840
"71",2024-06-10,"SSMH-SA","SSMH","SA","21398622",699,9,354,690
"72",2024-06-10,"SSMH-SB","SSMH","SB","21362319",573,12,292.5,561
"73",2024-06-10,"SSMH-SI","SSMH","SI","21398619",606,31,318.5,575
"74",2024-06-10,"TNHA-BASE","TNHA","BASE","21176526",672,11,341.5,661
"75",2024-06-10,"TNHA-SA","TNHA","SA","21398620",794,9,401.5,785
"76",2024-06-10,"TNHA-SB","TNHA","SB","21362318",589,24,306.5,565
"77",2024-06-10,"TNHA-SC","TNHA","SC","21362317",248,33,140.5,215
"78",2024-06-10,"TNHA-SD","TNHA","SD","21362315",757,14,385.5,743
"79",2024-06-11,"SSMH-BASE","SSMH","BASE","21390413",912,12,462,900
"80",2024-06-11,"SSMH-SA","SSMH","SA","21398622",681,11,346,670
"81",2024-06-11,"SSMH-SB","SSMH","SB","21362319",567,12,289.5,555
"82",2024-06-11,"SSMH-SI","SSMH","SI","21398619",541,39,290,502
"83",2024-06-11,"TNHA-BASE","TNHA","BASE","21176526",659,12,335.5,647
"84",2024-06-11,"TNHA-SA","TNHA","SA","21398620",801,9,405,792
"85",2024-06-11,"TNHA-SB","TNHA","SB","21362318",577,32,304.5,545
"86",2024-06-11,"TNHA-SC","TNHA","SC","21362317",244,37,140.5,207
"87",2024-06-11,"TNHA-SD","TNHA","SD","21362315",681,16,348.5,665
"88",2024-06-12,"SSMH-BASE","SSMH","BASE","21390413",878,12,445,866
"89",2024-06-12,"SSMH-SA","SSMH","SA","21398622",716,14,365,702
"90",2024-06-12,"SSMH-SB","SSMH","SB","21362319",589,13,301,576
"91",2024-06-12,"SSMH-SI","SSMH","SI","21398619",621,21,321,600
"92",2024-06-12,"TNHA-BASE","TNHA","BASE","21176526",688,19,353.5,669
"93",2024-06-12,"TNHA-SA","TNHA","SA","21398620",823,7,415,816
"94",2024-06-12,"TNHA-SB","TNHA","SB","21362318",602,26,314,576
"95",2024-06-12,"TNHA-SC","TNHA","SC","21362317",273,24,148.5,249
"96",2024-06-12,"TNHA-SD","TNHA","SD","21362315",783,9,396,774
"97",2024-06-13,"SSMH-BASE","SSMH","BASE","21390413",874,9,441.5,865
"98",2024-06-13,"SSMH-SA","SSMH","SA","21398622",717,9,363,708
"99",2024-06-13,"SSMH-SB","SSMH","SB","21362319",589,12,300.5,577
"100",2024-06-13,"SSMH-SI","SSMH","SI","21398619",621,27,324,594
"101",2024-06-13,"TNHA-BASE","TNHA","BASE","21176526",686,12,349,674
"102",2024-06-13,"TNHA-SA","TNHA","SA","21398620",828,11,419.5,817
"103",2024-06-13,"TNHA-SB","TNHA","SB","21362318",602,26,314,576
"104",2024-06-13,"TNHA-SC","TNHA","SC","21362317",468,28,248,440
"105",2024-06-13,"TNHA-SD","TNHA","SD","21362315",782,14,398,768
"106",2024-06-14,"SSMH-BASE","SSMH","BASE","21390413",729,9,369,720
"107",2024-06-14,"SSMH-SA","SSMH","SA","21398622",696,9,352.5,687
"108",2024-06-14,"SSMH-SB","SSMH","SB","21362319",582,12,297,570
"109",2024-06-14,"SSMH-SI","SSMH","SI","21398619",463,28,245.5,435
"110",2024-06-14,"TNHA-BASE","TNHA","BASE","21176526",681,12,346.5,669
"111",2024-06-14,"TNHA-SA","TNHA","SA","21398620",826,8,417,818
"112",2024-06-14,"TNHA-SB","TNHA","SB","21362318",584,28,306,556
"113",2024-06-14,"TNHA-SC","TNHA","SC","21362317",469,29,249,440
"114",2024-06-14,"TNHA-SD","TNHA","SD","21362315",476,14,245,462
"115",2024-06-15,"SSMH-BASE","SSMH","BASE","21390413",882,11,446.5,871
"116",2024-06-15,"SSMH-SA","SSMH","SA","21398622",678,13,345.5,665
"117",2024-06-15,"SSMH-SB","SSMH","SB","21362319",543,13,278,530
"118",2024-06-15,"SSMH-SI","SSMH","SI","21398619",508,31,269.5,477
"119",2024-06-15,"TNHA-BASE","TNHA","BASE","21176526",738,12,375,726
"120",2024-06-15,"TNHA-SA","TNHA","SA","21398620",773,8,390.5,765
"121",2024-06-15,"TNHA-SB","TNHA","SB","21362318",564,29,296.5,535
"122",2024-06-15,"TNHA-SC","TNHA","SC","21362317",291,19,155,272
"123",2024-06-15,"TNHA-SD","TNHA","SD","21362315",613,16,314.5,597
"124",2024-06-16,"SSMH-BASE","SSMH","BASE","21390413",486,13,249.5,473
"125",2024-06-16,"SSMH-SA","SSMH","SA","21398622",608,16,312,592
"126",2024-06-16,"SSMH-SB","SSMH","SB","21362319",519,12,265.5,507
"127",2024-06-16,"SSMH-SI","SSMH","SI","21398619",467,33,250,434
"128",2024-06-16,"TNHA-BASE","TNHA","BASE","21176526",623,13,318,610
"129",2024-06-16,"TNHA-SA","TNHA","SA","21398620",746,8,377,738
"130",2024-06-16,"TNHA-SB","TNHA","SB","21362318",551,36,293.5,515
"131",2024-06-16,"TNHA-SC","TNHA","SC","21362317",386,31,208.5,355
"132",2024-06-16,"TNHA-SD","TNHA","SD","21362315",572,16,294,556
"133",2024-06-17,"SSMH-BASE","SSMH","BASE","21390413",249,2,125.5,247
"134",2024-06-17,"SSMH-SA","SSMH","SA","21398622",534,4,269,530
"135",2024-06-17,"SSMH-SB","SSMH","SB","21362319",419,2,210.5,417
"136",2024-06-17,"SSMH-SI","SSMH","SI","21398619",278,3,140.5,275
"137",2024-06-17,"TNHA-BASE","TNHA","BASE","21176526",703,4,353.5,699
"138",2024-06-17,"TNHA-SA","TNHA","SA","21398620",573,1,287,572
"139",2024-06-17,"TNHA-SB","TNHA","SB","21362318",482,4,243,478
"140",2024-06-17,"TNHA-SC","TNHA","SC","21362317",301,2,151.5,299
"141",2024-06-17,"TNHA-SD","TNHA","SD","21362315",161,1,81,160
"142",2024-06-18,"SSMH-BASE","SSMH","BASE","21390413",972,9,490.5,963
"143",2024-06-18,"SSMH-SA","SSMH","SA","21398622",429,16,222.5,413
"144",2024-06-18,"SSMH-SB","SSMH","SB","21362319",282,11,146.5,271
"145",2024-06-18,"SSMH-SI","SSMH","SI","21398619",273,14,143.5,259
"146",2024-06-18,"TNHA-BASE","TNHA","BASE","21176526",396,9,202.5,387
"147",2024-06-18,"TNHA-SA","TNHA","SA","21398620",364,8,186,356
"148",2024-06-18,"TNHA-SB","TNHA","SB","21362318",391,17,204,374
"149",2024-06-18,"TNHA-SC","TNHA","SC","21362317",169,11,90,158
"150",2024-06-18,"TNHA-SD","TNHA","SD","21362315",337,9,173,328
"151",2024-06-19,"SSMH-BASE","SSMH","BASE","21390413",892,11,451.5,881
"152",2024-06-19,"SSMH-SA","SSMH","SA","21398622",719,11,365,708
"153",2024-06-19,"SSMH-SB","SSMH","SB","21362319",591,12,301.5,579
"154",2024-06-19,"SSMH-SI","SSMH","SI","21398619",592,26,309,566
"155",2024-06-19,"TNHA-BASE","TNHA","BASE","21176526",659,11,335,648
"156",2024-06-19,"TNHA-SA","TNHA","SA","21398620",812,9,410.5,803
"157",2024-06-19,"TNHA-SB","TNHA","SB","21362318",596,26,311,570
"158",2024-06-19,"TNHA-SC","TNHA","SC","21362317",438,28,233,410
"159",2024-06-19,"TNHA-SD","TNHA","SD","21362315",739,14,376.5,725
"160",2024-06-20,"SSMH-BASE","SSMH","BASE","21390413",843,11,427,832
"161",2024-06-20,"SSMH-SA","SSMH","SA","21398622",701,14,357.5,687
"162",2024-06-20,"SSMH-SB","SSMH","SB","21362319",583,9,296,574
"163",2024-06-20,"SSMH-SI","SSMH","SI","21398619",589,13,301,576
"164",2024-06-20,"TNHA-BASE","TNHA","BASE","21176526",654,14,334,640
"165",2024-06-20,"TNHA-SA","TNHA","SA","21398620",788,7,397.5,781
"166",2024-06-20,"TNHA-SB","TNHA","SB","21362318",578,16,297,562
"167",2024-06-20,"TNHA-SC","TNHA","SC","21362317",184,11,97.5,173
"168",2024-06-20,"TNHA-SD","TNHA","SD","21362315",746,8,377,738
"169",2024-06-21,"SSMH-BASE","SSMH","BASE","21390413",934,8,471,926
"170",2024-06-21,"SSMH-SA","SSMH","SA","21398622",678,8,343,670
"171",2024-06-21,"SSMH-SB","SSMH","SB","21362319",572,6,289,566
"172",2024-06-21,"SSMH-SI","SSMH","SI","21398619",471,13,242,458
"173",2024-06-21,"TNHA-BASE","TNHA","BASE","21176526",851,8,429.5,843
"174",2024-06-21,"TNHA-SA","TNHA","SA","21398620",783,4,393.5,779
"175",2024-06-21,"TNHA-SB","TNHA","SB","21362318",563,14,288.5,549
"176",2024-06-21,"TNHA-SC","TNHA","SC","21362317",437,14,225.5,423
"177",2024-06-21,"TNHA-SD","TNHA","SD","21362315",612,6,309,606
"178",2024-06-22,"SSMH-BASE","SSMH","BASE","21390413",821,12,416.5,809
"179",2024-06-22,"SSMH-SA","SSMH","SA","21398622",684,11,347.5,673
"180",2024-06-22,"SSMH-SB","SSMH","SB","21362319",568,12,290,556
"181",2024-06-22,"SSMH-SI","SSMH","SI","21398619",574,32,303,542
"182",2024-06-22,"TNHA-BASE","TNHA","BASE","21176526",626,12,319,614
"183",2024-06-22,"TNHA-SA","TNHA","SA","21398620",778,9,393.5,769
"184",2024-06-22,"TNHA-SB","TNHA","SB","21362318",596,32,314,564
"185",2024-06-22,"TNHA-SC","TNHA","SC","21362317",417,34,225.5,383
"186",2024-06-22,"TNHA-SD","TNHA","SD","21362315",721,13,367,708
"187",2024-06-23,"SSMH-BASE","SSMH","BASE","21390413",871,29,450,842
"188",2024-06-23,"SSMH-SA","SSMH","SA","21398622",706,32,369,674
"189",2024-06-23,"SSMH-SB","SSMH","SB","21362319",582,24,303,558
"190",2024-06-23,"SSMH-SI","SSMH","SI","21398619",606,41,323.5,565
"191",2024-06-23,"TNHA-BASE","TNHA","BASE","21176526",648,32,340,616
"192",2024-06-23,"TNHA-SA","TNHA","SA","21398620",797,18,407.5,779
"193",2024-06-23,"TNHA-SB","TNHA","SB","21362318",584,51,317.5,533
"194",2024-06-23,"TNHA-SC","TNHA","SC","21362317",286,27,156.5,259
"195",2024-06-23,"TNHA-SD","TNHA","SD","21362315",762,21,391.5,741
"196",2024-06-24,"SSMH-BASE","SSMH","BASE","21390413",837,12,424.5,825
"197",2024-06-24,"SSMH-SA","SSMH","SA","21398622",662,14,338,648
"198",2024-06-24,"SSMH-SB","SSMH","SB","21362319",554,9,281.5,545
"199",2024-06-24,"SSMH-SI","SSMH","SI","21398619",477,14,245.5,463
"200",2024-06-24,"TNHA-BASE","TNHA","BASE","21176526",634,14,324,620
"201",2024-06-24,"TNHA-SA","TNHA","SA","21398620",789,7,398,782
"202",2024-06-24,"TNHA-SB","TNHA","SB","21362318",564,17,290.5,547
"203",2024-06-24,"TNHA-SC","TNHA","SC","21362317",299,12,155.5,287
"204",2024-06-24,"TNHA-SD","TNHA","SD","21362315",571,8,289.5,563
"205",2024-06-25,"SSMH-BASE","SSMH","BASE","21390413",867,7,437,860
"206",2024-06-25,"SSMH-SA","SSMH","SA","21398622",671,8,339.5,663
"207",2024-06-25,"SSMH-SB","SSMH","SB","21362319",519,4,261.5,515
"208",2024-06-25,"SSMH-SI","SSMH","SI","21398619",552,7,279.5,545
"209",2024-06-25,"TNHA-BASE","TNHA","BASE","21176526",864,7,435.5,857
"210",2024-06-25,"TNHA-SA","TNHA","SA","21398620",714,3,358.5,711
"211",2024-06-25,"TNHA-SB","TNHA","SB","21362318",558,8,283,550
"212",2024-06-25,"TNHA-SC","TNHA","SC","21362317",234,4,119,230
"213",2024-06-25,"TNHA-SD","TNHA","SD","21362315",698,4,351,694
"214",2024-06-26,"SSMH-BASE","SSMH","BASE","21390413",646,8,327,638
"215",2024-06-26,"SSMH-SA","SSMH","SA","21398622",582,13,297.5,569
"216",2024-06-26,"SSMH-SB","SSMH","SB","21362319",457,9,233,448
"217",2024-06-26,"SSMH-SI","SSMH","SI","21398619",431,12,221.5,419
"218",2024-06-26,"TNHA-BASE","TNHA","BASE","21176526",542,7,274.5,535
"219",2024-06-26,"TNHA-SA","TNHA","SA","21398620",611,6,308.5,605
"220",2024-06-26,"TNHA-SB","TNHA","SB","21362318",499,14,256.5,485
"221",2024-06-26,"TNHA-SC","TNHA","SC","21362317",209,9,109,200
"222",2024-06-26,"TNHA-SD","TNHA","SD","21362315",504,8,256,496
"223",2024-06-27,"SSMH-BASE","SSMH","BASE","21390413",946,9,477.5,937
"224",2024-06-27,"SSMH-SA","SSMH","SA","21398622",541,11,276,530
"225",2024-06-27,"SSMH-SB","SSMH","SB","21362319",426,9,217.5,417
"226",2024-06-27,"SSMH-SI","SSMH","SI","21398619",329,17,173,312
"227",2024-06-27,"TNHA-BASE","TNHA","BASE","21176526",654,9,331.5,645
"228",2024-06-27,"TNHA-SA","TNHA","SA","21398620",579,7,293,572
"229",2024-06-27,"TNHA-SB","TNHA","SB","21362318",479,22,250.5,457
"230",2024-06-27,"TNHA-SC","TNHA","SC","21362317",281,18,149.5,263
"231",2024-06-27,"TNHA-SD","TNHA","SD","21362315",577,8,292.5,569
"232",2024-06-28,"SSMH-BASE","SSMH","BASE","21390413",787,4,395.5,783
"233",2024-06-28,"SSMH-SA","SSMH","SA","21398622",481,6,243.5,475
"234",2024-06-28,"SSMH-SB","SSMH","SB","21362319",347,4,175.5,343
"235",2024-06-28,"SSMH-SI","SSMH","SI","21398619",441,6,223.5,435
"236",2024-06-28,"TNHA-BASE","TNHA","BASE","21176526",618,4,311,614
"237",2024-06-28,"TNHA-SA","TNHA","SA","21398620",413,3,208,410
"238",2024-06-28,"TNHA-SB","TNHA","SB","21362318",427,7,217,420
"239",2024-06-28,"TNHA-SC","TNHA","SC","21362317",294,4,149,290
"240",2024-06-28,"TNHA-SD","TNHA","SD","21362315",493,3,248,490
"241",2024-06-29,"SSMH-BASE","SSMH","BASE","21390413",809,4,406.5,805
"242",2024-06-29,"SSMH-SA","SSMH","SA","21398622",643,8,325.5,635
"243",2024-06-29,"SSMH-SB","SSMH","SB","21362319",529,4,266.5,525
"244",2024-06-29,"SSMH-SI","SSMH","SI","21398619",513,7,260,506
"245",2024-06-29,"TNHA-BASE","TNHA","BASE","21176526",599,6,302.5,593
"246",2024-06-29,"TNHA-SA","TNHA","SA","21398620",704,3,353.5,701
"247",2024-06-29,"TNHA-SB","TNHA","SB","21362318",538,8,273,530
"248",2024-06-29,"TNHA-SC","TNHA","SC","21362317",144,4,74,140
"249",2024-06-29,"TNHA-SD","TNHA","SD","21362315",651,4,327.5,647
"250",2024-06-30,"SSMH-BASE","SSMH","BASE","21390413",733,12,372.5,721
"251",2024-06-30,"SSMH-SA","SSMH","SA","21398622",553,12,282.5,541
"252",2024-06-30,"SSMH-SB","SSMH","SB","21362319",412,9,210.5,403
"253",2024-06-30,"SSMH-SI","SSMH","SI","21398619",417,21,219,396
"254",2024-06-30,"TNHA-BASE","TNHA","BASE","21176526",628,12,320,616
"255",2024-06-30,"TNHA-SA","TNHA","SA","21398620",579,6,292.5,573
"256",2024-06-30,"TNHA-SB","TNHA","SB","21362318",489,22,255.5,467
"257",2024-06-30,"TNHA-SC","TNHA","SC","21362317",166,22,94,144
"258",2024-06-30,"TNHA-SD","TNHA","SD","21362315",428,8,218,420
"259",2024-07-01,"SSMH-BASE","SSMH","BASE","21390413",802,6,404,796
"260",2024-07-01,"SSMH-SA","SSMH","SA","21398622",563,6,284.5,557
"261",2024-07-01,"SSMH-SB","SSMH","SB","21362319",376,4,190,372
"262",2024-07-01,"SSMH-SI","SSMH","SI","21398619",531,7,269,524
"263",2024-07-01,"TNHA-BASE","TNHA","BASE","21176526",527,7,267,520
"264",2024-07-01,"TNHA-SA","TNHA","SA","21398620",544,2,273,542
"265",2024-07-01,"TNHA-SB","TNHA","SB","21362318",486,7,246.5,479
"266",2024-07-01,"TNHA-SC","TNHA","SC","21362317",383,6,194.5,377
"267",2024-07-01,"TNHA-SD","TNHA","SD","21362315",653,3,328,650
"268",2024-07-02,"SSMH-BASE","SSMH","BASE","21390413",248,2,125,246
"269",2024-07-02,"SSMH-SA","SSMH","SA","21398622",294,6,150,288
"270",2024-07-02,"SSMH-SB","SSMH","SB","21362319",241,3,122,238
"271",2024-07-02,"SSMH-SI","SSMH","SI","21398619",242,6,124,236
"272",2024-07-02,"TNHA-BASE","TNHA","BASE","21176526",376,6,191,370
"273",2024-07-02,"TNHA-SA","TNHA","SA","21398620",213,2,107.5,211
"274",2024-07-02,"TNHA-SB","TNHA","SB","21362318",322,6,164,316
"275",2024-07-02,"TNHA-SC","TNHA","SC","21362317",301,4,152.5,297
"276",2024-07-02,"TNHA-SD","TNHA","SD","21362315",173,2,87.5,171
"277",2024-07-03,"SSMH-BASE","SSMH","BASE","21390413",136,3,69.5,133
"278",2024-07-03,"SSMH-SA","SSMH","SA","21398622",113,2,57.5,111
"279",2024-07-03,"SSMH-SB","SSMH","SB","21362319",82,1,41.5,81
"280",2024-07-03,"SSMH-SI","SSMH","SI","21398619",99,2,50.5,97
"281",2024-07-03,"TNHA-BASE","TNHA","BASE","21176526",174,3,88.5,171
"282",2024-07-03,"TNHA-SA","TNHA","SA","21398620",59,1,30,58
"283",2024-07-03,"TNHA-SB","TNHA","SB","21362318",111,2,56.5,109
"284",2024-07-03,"TNHA-SC","TNHA","SC","21362317",68,19,43.5,49
"285",2024-07-03,"TNHA-SD","TNHA","SD","21362315",67,1,34,66
"286",2024-07-04,"SSMH-BASE","SSMH","BASE","21390413",377,12,194.5,365
"287",2024-07-04,"SSMH-SA","SSMH","SA","21398622",394,12,203,382
"288",2024-07-04,"SSMH-SB","SSMH","SB","21362319",282,8,145,274
"289",2024-07-04,"SSMH-SI","SSMH","SI","21398619",264,11,137.5,253
"290",2024-07-04,"TNHA-BASE","TNHA","BASE","21176526",306,13,159.5,293
"291",2024-07-04,"TNHA-SA","TNHA","SA","21398620",311,6,158.5,305
"292",2024-07-04,"TNHA-SB","TNHA","SB","21362318",369,12,190.5,357
"293",2024-07-04,"TNHA-SD","TNHA","SD","21362315",242,6,124,236
"294",2024-07-05,"SSMH-BASE","SSMH","BASE","21390413",613,9,311,604
"295",2024-07-05,"SSMH-SA","SSMH","SA","21398622",527,11,269,516
"296",2024-07-05,"SSMH-SB","SSMH","SB","21362319",363,12,187.5,351
"297",2024-07-05,"SSMH-SI","SSMH","SI","21398619",457,32,244.5,425
"298",2024-07-05,"TNHA-BASE","TNHA","BASE","21176526",757,11,384,746
"299",2024-07-05,"TNHA-SA","TNHA","SA","21398620",483,9,246,474
"300",2024-07-05,"TNHA-SB","TNHA","SB","21362318",476,46,261,430
"301",2024-07-05,"TNHA-SD","TNHA","SD","21362315",589,13,301,576
"302",2024-07-06,"SSMH-BASE","SSMH","BASE","21390413",707,7,357,700
"303",2024-07-06,"SSMH-SA","SSMH","SA","21398622",488,6,247,482
"304",2024-07-06,"SSMH-SB","SSMH","SB","21362319",311,4,157.5,307
"305",2024-07-06,"SSMH-SI","SSMH","SI","21398619",373,6,189.5,367
"306",2024-07-06,"TNHA-BASE","TNHA","BASE","21176526",702,8,355,694
"307",2024-07-06,"TNHA-SA","TNHA","SA","21398620",377,3,190,374
"308",2024-07-06,"TNHA-SB","TNHA","SB","21362318",428,7,217.5,421
"309",2024-07-06,"TNHA-SD","TNHA","SD","21362315",408,3,205.5,405
"310",2024-07-07,"SSMH-BASE","SSMH","BASE","21390413",313,9,161,304
"311",2024-07-07,"SSMH-SA","SSMH","SA","21398622",347,11,179,336
"312",2024-07-07,"SSMH-SB","SSMH","SB","21362319",224,7,115.5,217
"313",2024-07-07,"SSMH-SI","SSMH","SI","21398619",283,9,146,274
"314",2024-07-07,"TNHA-BASE","TNHA","BASE","21176526",316,12,164,304
"315",2024-07-07,"TNHA-SA","TNHA","SA","21398620",277,4,140.5,273
"316",2024-07-07,"TNHA-SB","TNHA","SB","21362318",362,9,185.5,353
"317",2024-07-07,"TNHA-SD","TNHA","SD","21362315",266,6,136,260
"318",2024-07-08,"SSMH-BASE","SSMH","BASE","21390413",318,13,165.5,305
"319",2024-07-08,"SSMH-SA","SSMH","SA","21398622",273,16,144.5,257
"320",2024-07-08,"SSMH-SB","SSMH","SB","21362319",208,12,110,196
"321",2024-07-08,"SSMH-SI","SSMH","SI","21398619",242,21,131.5,221
"322",2024-07-08,"TNHA-BASE","TNHA","BASE","21176526",311,16,163.5,295
"323",2024-07-08,"TNHA-SA","TNHA","SA","21398620",198,8,103,190
"324",2024-07-08,"TNHA-SB","TNHA","SB","21362318",292,24,158,268
"325",2024-07-08,"TNHA-SD","TNHA","SD","21362315",171,9,90,162
"326",2024-07-09,"SSMH-BASE","SSMH","BASE","21390413",856,8,432,848
"327",2024-07-09,"SSMH-SA","SSMH","SA","21398622",688,11,349.5,677
"328",2024-07-09,"SSMH-SB","SSMH","SB","21362319",573,11,292,562
"329",2024-07-09,"SSMH-SI","SSMH","SI","21398619",596,22,309,574
"330",2024-07-09,"TNHA-BASE","TNHA","BASE","21176526",687,9,348,678
"331",2024-07-09,"TNHA-SA","TNHA","SA","21398620",709,6,357.5,703
"332",2024-07-09,"TNHA-SB","TNHA","SB","21362318",549,22,285.5,527
"333",2024-07-09,"TNHA-SD","TNHA","SD","21362315",738,8,373,730
"334",2024-07-10,"SSMH-BASE","SSMH","BASE","21390413",846,8,427,838
"335",2024-07-10,"SSMH-SA","SSMH","SA","21398622",717,8,362.5,709
"336",2024-07-10,"SSMH-SB","SSMH","SB","21362319",586,9,297.5,577
"337",2024-07-10,"SSMH-SI","SSMH","SI","21398619",573,37,305,536
"338",2024-07-10,"TNHA-BASE","TNHA","BASE","21176526",664,8,336,656
"339",2024-07-10,"TNHA-SA","TNHA","SA","21398620",807,8,407.5,799
"340",2024-07-10,"TNHA-SB","TNHA","SB","21362318",552,24,288,528
"341",2024-07-10,"TNHA-SD","TNHA","SD","21362315",721,11,366,710
"342",2024-07-11,"SSMH-BASE","SSMH","BASE","21390413",848,8,428,840
"343",2024-07-11,"SSMH-SA","SSMH","SA","21398622",687,7,347,680
"344",2024-07-11,"SSMH-SB","SSMH","SB","21362319",579,6,292.5,573
"345",2024-07-11,"SSMH-SI","SSMH","SI","21398619",564,23,293.5,541
"346",2024-07-11,"TNHA-BASE","TNHA","BASE","21176526",703,7,355,696
"347",2024-07-11,"TNHA-SA","TNHA","SA","21398620",736,4,370,732
"348",2024-07-11,"TNHA-SB","TNHA","SB","21362318",549,23,286,526
"349",2024-07-11,"TNHA-SD","TNHA","SD","21362315",708,8,358,700
"350",2024-07-12,"SSMH-BASE","SSMH","BASE","21390413",737,9,373,728
"351",2024-07-12,"SSMH-SA","SSMH","SA","21398622",679,12,345.5,667
"352",2024-07-12,"SSMH-SB","SSMH","SB","21362319",573,12,292.5,561
"353",2024-07-12,"SSMH-SI","SSMH","SI","21398619",438,22,230,416
"354",2024-07-12,"TNHA-BASE","TNHA","BASE","21176526",771,11,391,760
"355",2024-07-12,"TNHA-SA","TNHA","SA","21398620",789,6,397.5,783
"356",2024-07-12,"TNHA-SB","TNHA","SB","21362318",533,29,281,504
"357",2024-07-12,"TNHA-SD","TNHA","SD","21362315",398,8,203,390
"358",2024-07-13,"SSMH-BASE","SSMH","BASE","21390413",246,12,129,234
"359",2024-07-13,"SSMH-SA","SSMH","SA","21398622",541,13,277,528
"360",2024-07-13,"SSMH-SB","SSMH","SB","21362319",413,9,211,404
"361",2024-07-13,"SSMH-SI","SSMH","SI","21398619",209,13,111,196
"362",2024-07-13,"TNHA-BASE","TNHA","BASE","21176526",432,13,222.5,419
"363",2024-07-13,"TNHA-SA","TNHA","SA","21398620",553,6,279.5,547
"364",2024-07-13,"TNHA-SB","TNHA","SB","21362318",449,14,231.5,435
"365",2024-07-13,"TNHA-SD","TNHA","SD","21362315",146,7,76.5,139
"366",2024-07-14,"SSMH-BASE","SSMH","BASE","21390413",492,6,249,486
"367",2024-07-14,"SSMH-SA","SSMH","SA","21398622",377,8,192.5,369
"368",2024-07-14,"SSMH-SB","SSMH","SB","21362319",146,7,76.5,139
"369",2024-07-14,"SSMH-SI","SSMH","SI","21398619",339,12,175.5,327
"370",2024-07-14,"TNHA-BASE","TNHA","BASE","21176526",358,6,182,352
"371",2024-07-14,"TNHA-SA","TNHA","SA","21398620",141,4,72.5,137
"372",2024-07-14,"TNHA-SB","TNHA","SB","21362318",328,13,170.5,315
"373",2024-07-14,"TNHA-SD","TNHA","SD","21362315",394,6,200,388
"374",2024-07-15,"SSMH-BASE","SSMH","BASE","21390413",132,2,67,130
"375",2024-07-15,"SSMH-SA","SSMH","SA","21398622",119,3,61,116
"376",2024-07-15,"SSMH-SB","SSMH","SB","21362319",84,2,43,82
"377",2024-07-15,"SSMH-SI","SSMH","SI","21398619",103,2,52.5,101
"378",2024-07-15,"TNHA-BASE","TNHA","BASE","21176526",138,2,70,136
"379",2024-07-15,"TNHA-SA","TNHA","SA","21398620",72,1,36.5,71
"380",2024-07-15,"TNHA-SB","TNHA","SB","21362318",127,2,64.5,125
"381",2024-07-15,"TNHA-SD","TNHA","SD","21362315",78,1,39.5,77
"382",2024-07-16,"SSMH-BASE","SSMH","BASE","21390413",389,3,196,386
"383",2024-07-16,"SSMH-SA","SSMH","SA","21398622",331,4,167.5,327
"384",2024-07-16,"SSMH-SB","SSMH","SB","21362319",236,2,119,234
"385",2024-07-16,"SSMH-SI","SSMH","SI","21398619",251,3,127,248
"386",2024-07-16,"TNHA-BASE","TNHA","BASE","21176526",438,3,220.5,435
"387",2024-07-16,"TNHA-SA","TNHA","SA","21398620",302,1,151.5,301
"388",2024-07-16,"TNHA-SB","TNHA","SB","21362318",366,3,184.5,363
"389",2024-07-16,"TNHA-SD","TNHA","SD","21362315",228,2,115,226
"390",2024-07-17,"SSMH-BASE","SSMH","BASE","21390413",203,2,102.5,201
"391",2024-07-17,"SSMH-SA","SSMH","SA","21398622",397,2,199.5,395
"392",2024-07-17,"SSMH-SB","SSMH","SB","21362319",332,1,166.5,331
"393",2024-07-17,"SSMH-SI","SSMH","SI","21398619",286,1,143.5,285
"394",2024-07-17,"TNHA-BASE","TNHA","BASE","21176526",429,2,215.5,427
"395",2024-07-17,"TNHA-SA","TNHA","SA","21398620",383,1,192,382
"396",2024-07-17,"TNHA-SB","TNHA","SB","21362318",361,2,181.5,359
"397",2024-07-17,"TNHA-SD","TNHA","SD","21362315",141,1,71,140
"398",2024-07-18,"SSMH-BASE","SSMH","BASE","21390413",223,1,112,222
"399",2024-07-18,"SSMH-SA","SSMH","SA","21398622",318,2,160,316
"400",2024-07-18,"SSMH-SB","SSMH","SB","21362319",141,1,71,140
"401",2024-07-18,"SSMH-SI","SSMH","SI","21398619",296,1,148.5,295
"402",2024-07-18,"TNHA-BASE","TNHA","BASE","21176526",217,1,109,216
"403",2024-07-18,"TNHA-SA","TNHA","SA","21398620",121,1,61,120
"404",2024-07-18,"TNHA-SB","TNHA","SB","21362318",211,2,106.5,209
"405",2024-07-18,"TNHA-SD","TNHA","SD","21362315",322,1,161.5,321
"406",2024-07-19,"BEO-BASE","BEO","BASE","21390415",637,11,324,626
"407",2024-07-19,"SSMH-BASE","SSMH","BASE","21390413",734,7,370.5,727
"408",2024-07-19,"SSMH-SA","SSMH","SA","21398622",566,7,286.5,559
"409",2024-07-19,"SSMH-SB","SSMH","SB","21362319",357,6,181.5,351
"410",2024-07-19,"SSMH-SI","SSMH","SI","21398619",493,12,252.5,481
"411",2024-07-19,"TNHA-BASE","TNHA","BASE","21176526",574,7,290.5,567
"412",2024-07-19,"TNHA-SA","TNHA","SA","21398620",531,3,267,528
"413",2024-07-19,"TNHA-SB","TNHA","SB","21362318",472,16,244,456
"414",2024-07-19,"TNHA-SD","TNHA","SD","21362315",613,4,308.5,609
"415",2024-07-20,"BEO-BASE","BEO","BASE","21390415",514,6,260,508
"416",2024-07-20,"SSMH-BASE","SSMH","BASE","21390413",232,2,117,230
"417",2024-07-20,"SSMH-SA","SSMH","SA","21398622",412,4,208,408
"418",2024-07-20,"SSMH-SB","SSMH","SB","21362319",309,2,155.5,307
"419",2024-07-20,"SSMH-SI","SSMH","SI","21398619",213,3,108,210
"420",2024-07-20,"TNHA-BASE","TNHA","BASE","21176526",472,3,237.5,469
"421",2024-07-20,"TNHA-SA","TNHA","SA","21398620",326,1,163.5,325
"422",2024-07-20,"TNHA-SB","TNHA","SB","21362318",351,3,177,348
"423",2024-07-20,"TNHA-SD","TNHA","SD","21362315",171,2,86.5,169
"424",2024-07-21,"BEO-BASE","BEO","BASE","21390415",433,6,219.5,427
"425",2024-07-21,"SSMH-BASE","SSMH","BASE","21390413",543,2,272.5,541
"426",2024-07-21,"SSMH-SA","SSMH","SA","21398622",411,6,208.5,405
"427",2024-07-21,"SSMH-SB","SSMH","SB","21362319",261,4,132.5,257
"428",2024-07-21,"SSMH-SI","SSMH","SI","21398619",284,6,145,278
"429",2024-07-21,"TNHA-BASE","TNHA","BASE","21176526",388,3,195.5,385
"430",2024-07-21,"TNHA-SA","TNHA","SA","21398620",323,2,162.5,321
"431",2024-07-21,"TNHA-SB","TNHA","SB","21362318",362,6,184,356
"432",2024-07-21,"TNHA-SD","TNHA","SD","21362315",308,2,155,306
"433",2024-07-22,"BEO-BASE","BEO","BASE","21390415",303,1,152,302
"434",2024-07-22,"SSMH-BASE","SSMH","BASE","21390413",144,1,72.5,143
"435",2024-07-22,"SSMH-SA","SSMH","SA","21398622",209,1,105,208
"436",2024-07-22,"SSMH-SB","SSMH","SB","21362319",161,1,81,160
"437",2024-07-22,"SSMH-SI","SSMH","SI","21398619",169,1,85,168
"438",2024-07-22,"TNHA-BASE","TNHA","BASE","21176526",159,1,80,158
"439",2024-07-22,"TNHA-SA","TNHA","SA","21398620",148,1,74.5,147
"440",2024-07-22,"TNHA-SB","TNHA","SB","21362318",219,1,110,218
"441",2024-07-22,"TNHA-SD","TNHA","SD","21362315",114,1,57.5,113
"442",2024-07-23,"BEO-BASE","BEO","BASE","21390415",338,7,172.5,331
"443",2024-07-23,"SSMH-BASE","SSMH","BASE","21390413",214,4,109,210
"444",2024-07-23,"SSMH-SA","SSMH","SA","21398622",274,4,139,270
"445",2024-07-23,"SSMH-SB","SSMH","SB","21362319",178,2,90,176
"446",2024-07-23,"SSMH-SI","SSMH","SI","21398619",217,4,110.5,213
"447",2024-07-23,"TNHA-BASE","TNHA","BASE","21176526",241,6,123.5,235
"448",2024-07-23,"TNHA-SA","TNHA","SA","21398620",161,2,81.5,159
"449",2024-07-23,"TNHA-SB","TNHA","SB","21362318",248,4,126,244
"450",2024-07-23,"TNHA-SD","TNHA","SD","21362315",167,2,84.5,165
"451",2024-07-24,"BEO-BASE","BEO","BASE","21390415",376,8,192,368
"452",2024-07-24,"SSMH-BASE","SSMH","BASE","21390413",298,4,151,294
"453",2024-07-24,"SSMH-SA","SSMH","SA","21398622",298,4,151,294
"454",2024-07-24,"SSMH-SB","SSMH","SB","21362319",253,4,128.5,249
"455",2024-07-24,"SSMH-SI","SSMH","SI","21398619",224,12,118,212
"456",2024-07-24,"TNHA-BASE","TNHA","BASE","21176526",312,4,158,308
"457",2024-07-24,"TNHA-SA","TNHA","SA","21398620",232,2,117,230
"458",2024-07-24,"TNHA-SB","TNHA","SB","21362318",289,28,158.5,261
"459",2024-07-24,"TNHA-SD","TNHA","SD","21362315",209,6,107.5,203
"460",2024-07-25,"BEO-BASE","BEO","BASE","21390415",656,13,334.5,643
"461",2024-07-25,"SSMH-BASE","SSMH","BASE","21390413",601,6,303.5,595
"462",2024-07-25,"SSMH-SA","SSMH","SA","21398622",558,6,282,552
"463",2024-07-25,"SSMH-SB","SSMH","SB","21362319",373,4,188.5,369
"464",2024-07-25,"SSMH-SI","SSMH","SI","21398619",451,12,231.5,439
"465",2024-07-25,"TNHA-BASE","TNHA","BASE","21176526",389,6,197.5,383
"466",2024-07-25,"TNHA-SA","TNHA","SA","21398620",442,3,222.5,439
"467",2024-07-25,"TNHA-SB","TNHA","SB","21362318",394,22,208,372
"468",2024-07-25,"TNHA-SD","TNHA","SD","21362315",498,7,252.5,491
"469",2024-07-26,"BEO-BASE","BEO","BASE","21390415",359,8,183.5,351
"470",2024-07-26,"SSMH-BASE","SSMH","BASE","21390413",171,4,87.5,167
"471",2024-07-26,"SSMH-SA","SSMH","SA","21398622",314,6,160,308
"472",2024-07-26,"SSMH-SB","SSMH","SB","21362319",228,4,116,224
"473",2024-07-26,"SSMH-SI","SSMH","SI","21398619",214,6,110,208
"474",2024-07-26,"TNHA-BASE","TNHA","BASE","21176526",219,4,111.5,215
"475",2024-07-26,"TNHA-SA","TNHA","SA","21398620",232,2,117,230
"476",2024-07-26,"TNHA-SB","TNHA","SB","21362318",291,6,148.5,285
"477",2024-07-26,"TNHA-SD","TNHA","SD","21362315",159,3,81,156
"478",2024-07-27,"BEO-BASE","BEO","BASE","21390415",503,3,253,500
"479",2024-07-27,"SSMH-BASE","SSMH","BASE","21390413",331,4,167.5,327
"480",2024-07-27,"SSMH-SA","SSMH","SA","21398622",262,3,132.5,259
"481",2024-07-27,"SSMH-SB","SSMH","SB","21362319",178,2,90,176
"482",2024-07-27,"SSMH-SI","SSMH","SI","21398619",216,3,109.5,213
"483",2024-07-27,"TNHA-BASE","TNHA","BASE","21176526",297,4,150.5,293
"484",2024-07-27,"TNHA-SA","TNHA","SA","21398620",176,1,88.5,175
"485",2024-07-27,"TNHA-SB","TNHA","SB","21362318",262,3,132.5,259
"486",2024-07-27,"TNHA-SD","TNHA","SD","21362315",192,1,96.5,191
"487",2024-07-28,"BEO-BASE","BEO","BASE","21390415",503,2,252.5,501
"488",2024-07-28,"SSMH-BASE","SSMH","BASE","21390413",341,2,171.5,339
"489",2024-07-28,"SSMH-SA","SSMH","SA","21398622",361,1,181,360
"490",2024-07-28,"SSMH-SB","SSMH","SB","21362319",242,1,121.5,241
"491",2024-07-28,"SSMH-SI","SSMH","SI","21398619",254,1,127.5,253
"492",2024-07-28,"TNHA-BASE","TNHA","BASE","21176526",373,2,187.5,371
"493",2024-07-28,"TNHA-SA","TNHA","SA","21398620",271,1,136,270
"494",2024-07-28,"TNHA-SB","TNHA","SB","21362318",329,1,165,328
"495",2024-07-28,"TNHA-SD","TNHA","SD","21362315",218,1,109.5,217
"496",2024-07-29,"BEO-BASE","BEO","BASE","21390415",251,2,126.5,249
"497",2024-07-29,"SSMH-BASE","SSMH","BASE","21390413",248,1,124.5,247
"498",2024-07-29,"SSMH-SA","SSMH","SA","21398622",284,1,142.5,283
"499",2024-07-29,"SSMH-SB","SSMH","SB","21362319",209,1,105,208
"500",2024-07-29,"SSMH-SI","SSMH","SI","21398619",212,1,106.5,211
"501",2024-07-29,"TNHA-BASE","TNHA","BASE","21176526",316,1,158.5,315
"502",2024-07-29,"TNHA-SA","TNHA","SA","21398620",219,1,110,218
"503",2024-07-29,"TNHA-SB","TNHA","SB","21362318",283,1,142,282
"504",2024-07-29,"TNHA-SD","TNHA","SD","21362315",158,1,79.5,157
"505",2024-07-30,"BEO-BASE","BEO","BASE","21390415",334,2,168,332
"506",2024-07-30,"SSMH-BASE","SSMH","BASE","21390413",286,1,143.5,285
"507",2024-07-30,"SSMH-SA","SSMH","SA","21398622",226,1,113.5,225
"508",2024-07-30,"SSMH-SB","SSMH","SB","21362319",152,1,76.5,151
"509",2024-07-30,"SSMH-SI","SSMH","SI","21398619",194,1,97.5,193
"510",2024-07-30,"TNHA-BASE","TNHA","BASE","21176526",343,1,172,342
"511",2024-07-30,"TNHA-SA","TNHA","SA","21398620",157,1,79,156
"512",2024-07-30,"TNHA-SB","TNHA","SB","21362318",237,1,119,236
"513",2024-07-30,"TNHA-SD","TNHA","SD","21362315",156,1,78.5,155
"514",2024-07-31,"BEO-BASE","BEO","BASE","21390415",291,3,147,288
"515",2024-07-31,"SSMH-BASE","SSMH","BASE","21390413",228,2,115,226
"516",2024-07-31,"SSMH-SA","SSMH","SA","21398622",384,2,193,382
"517",2024-07-31,"SSMH-SB","SSMH","SB","21362319",269,1,135,268
"518",2024-07-31,"SSMH-SI","SSMH","SI","21398619",249,2,125.5,247
"519",2024-07-31,"TNHA-BASE","TNHA","BASE","21176526",269,2,135.5,267
"520",2024-07-31,"TNHA-SA","TNHA","SA","21398620",288,1,144.5,287
"521",2024-07-31,"TNHA-SB","TNHA","SB","21362318",324,2,163,322
"522",2024-07-31,"TNHA-SD","TNHA","SD","21362315",177,1,89,176
"523",2024-08-01,"BEO-BASE","BEO","BASE","21390415",332,2,167,330
"524",2024-08-01,"SSMH-BASE","SSMH","BASE","21390413",214,2,108,212
"525",2024-08-01,"SSMH-SA","SSMH","SA","21398622",301,2,151.5,299
"526",2024-08-01,"SSMH-SB","SSMH","SB","21362319",272,1,136.5,271
"527",2024-08-01,"SSMH-SI","SSMH","SI","21398619",192,2,97,190
"528",2024-08-01,"TNHA-BASE","TNHA","BASE","21176526",221,2,111.5,219
"529",2024-08-01,"TNHA-SA","TNHA","SA","21398620",363,1,182,362
"530",2024-08-01,"TNHA-SB","TNHA","SB","21362318",328,2,165,326
"531",2024-08-01,"TNHA-SD","TNHA","SD","21362315",146,1,73.5,145
"532",2024-08-02,"BEO-BASE","BEO","BASE","21390415",753,1,377,752
"533",2024-08-02,"SSMH-BASE","SSMH","BASE","21390413",329,1,165,328
"534",2024-08-02,"SSMH-SA","SSMH","SA","21398622",473,1,237,472
"535",2024-08-02,"SSMH-SB","SSMH","SB","21362319",339,1,170,338
"536",2024-08-02,"SSMH-SI","SSMH","SI","21398619",253,1,127,252
"537",2024-08-02,"TNHA-BASE","TNHA","BASE","21176526",333,1,167,332
"538",2024-08-02,"TNHA-SA","TNHA","SA","21398620",444,1,222.5,443
"539",2024-08-02,"TNHA-SB","TNHA","SB","21362318",397,1,199,396
"540",2024-08-02,"TNHA-SD","TNHA","SD","21362315",241,1,121,240
"541",2024-08-03,"BEO-BASE","BEO","BASE","21390415",498,4,251,494
"542",2024-08-03,"SSMH-BASE","SSMH","BASE","21390413",242,2,122,240
"543",2024-08-03,"SSMH-SA","SSMH","SA","21398622",471,2,236.5,469
"544",2024-08-03,"SSMH-SB","SSMH","SB","21362319",397,2,199.5,395
"545",2024-08-03,"SSMH-SI","SSMH","SI","21398619",221,4,112.5,217
"546",2024-08-03,"TNHA-BASE","TNHA","BASE","21176526",422,1,211.5,421
"547",2024-08-03,"TNHA-SA","TNHA","SA","21398620",512,1,256.5,511
"548",2024-08-03,"TNHA-SB","TNHA","SB","21362318",414,4,209,410
"549",2024-08-03,"TNHA-SD","TNHA","SD","21362315",153,1,77,152
"550",2024-08-04,"BEO-BASE","BEO","BASE","21390415",276,1,138.5,275
"551",2024-08-04,"SSMH-BASE","SSMH","BASE","21390413",201,1,101,200
"552",2024-08-04,"SSMH-SA","SSMH","SA","21398622",271,1,136,270
"553",2024-08-04,"SSMH-SB","SSMH","SB","21362319",141,1,71,140
"554",2024-08-04,"SSMH-SI","SSMH","SI","21398619",218,1,109.5,217
"555",2024-08-04,"TNHA-BASE","TNHA","BASE","21176526",207,1,104,206
"556",2024-08-04,"TNHA-SA","TNHA","SA","21398620",182,1,91.5,181
"557",2024-08-04,"TNHA-SB","TNHA","SB","21362318",239,1,120,238
"558",2024-08-04,"TNHA-SD","TNHA","SD","21362315",206,1,103.5,205
"559",2024-08-05,"BEO-BASE","BEO","BASE","21390415",458,1,229.5,457
"560",2024-08-05,"SSMH-BASE","SSMH","BASE","21390413",926,1,463.5,925
"561",2024-08-05,"SSMH-SA","SSMH","SA","21398622",398,1,199.5,397
"562",2024-08-05,"SSMH-SB","SSMH","SB","21362319",289,1,145,288
"563",2024-08-05,"SSMH-SI","SSMH","SI","21398619",258,1,129.5,257
"564",2024-08-05,"TNHA-BASE","TNHA","BASE","21176526",488,1,244.5,487
"565",2024-08-05,"TNHA-SA","TNHA","SA","21398620",348,1,174.5,347
"566",2024-08-05,"TNHA-SB","TNHA","SB","21362318",316,1,158.5,315
"567",2024-08-05,"TNHA-SD","TNHA","SD","21362315",298,1,149.5,297
"568",2024-08-06,"BEO-BASE","BEO","BASE","21390415",452,1,226.5,451
"569",2024-08-06,"SSMH-BASE","SSMH","BASE","21390413",584,1,292.5,583
"570",2024-08-06,"SSMH-SA","SSMH","SA","21398622",427,1,214,426
"571",2024-08-06,"SSMH-SB","SSMH","SB","21362319",332,1,166.5,331
"572",2024-08-06,"SSMH-SI","SSMH","SI","21398619",388,1,194.5,387
"573",2024-08-06,"TNHA-BASE","TNHA","BASE","21176526",559,1,280,558
"574",2024-08-06,"TNHA-SA","TNHA","SA","21398620",463,1,232,462
"575",2024-08-06,"TNHA-SB","TNHA","SB","21362318",376,1,188.5,375
"576",2024-08-06,"TNHA-SD","TNHA","SD","21362315",491,1,246,490
"577",2024-08-07,"BEO-BASE","BEO","BASE","21390415",423,1,212,422
"578",2024-08-07,"SSMH-BASE","SSMH","BASE","21390413",178,1,89.5,177
"579",2024-08-07,"SSMH-SA","SSMH","SA","21398622",304,1,152.5,303
"580",2024-08-07,"SSMH-SB","SSMH","SB","21362319",279,1,140,278
"581",2024-08-07,"SSMH-SI","SSMH","SI","21398619",152,1,76.5,151
"582",2024-08-07,"TNHA-BASE","TNHA","BASE","21176526",187,1,94,186
"583",2024-08-07,"TNHA-SA","TNHA","SA","21398620",322,1,161.5,321
"584",2024-08-07,"TNHA-SB","TNHA","SB","21362318",303,1,152,302
"585",2024-08-07,"TNHA-SD","TNHA","SD","21362315",122,1,61.5,121
"586",2024-08-08,"BEO-BASE","BEO","BASE","21390415",318,1,159.5,317
"587",2024-08-08,"SSMH-BASE","SSMH","BASE","21390413",227,1,114,226
"588",2024-08-08,"SSMH-SA","SSMH","SA","21398622",266,1,133.5,265
"589",2024-08-08,"SSMH-SB","SSMH","SB","21362319",197,1,99,196
"590",2024-08-08,"SSMH-SI","SSMH","SI","21398619",194,1,97.5,193
"591",2024-08-08,"TNHA-BASE","TNHA","BASE","21176526",232,1,116.5,231
"592",2024-08-08,"TNHA-SA","TNHA","SA","21398620",216,1,108.5,215
"593",2024-08-08,"TNHA-SB","TNHA","SB","21362318",258,1,129.5,257
"594",2024-08-08,"TNHA-SD","TNHA","SD","21362315",147,1,74,146
"595",2024-08-09,"BEO-BASE","BEO","BASE","21390415",357,1,179,356
"596",2024-08-09,"SSMH-BASE","SSMH","BASE","21390413",371,1,186,370
"597",2024-08-09,"SSMH-SA","SSMH","SA","21398622",311,1,156,310
"598",2024-08-09,"SSMH-SB","SSMH","SB","21362319",193,1,97,192
"599",2024-08-09,"SSMH-SI","SSMH","SI","21398619",239,1,120,238
"600",2024-08-09,"TNHA-BASE","TNHA","BASE","21176526",309,1,155,308
"601",2024-08-09,"TNHA-SA","TNHA","SA","21398620",248,1,124.5,247
"602",2024-08-09,"TNHA-SB","TNHA","SB","21362318",294,1,147.5,293
"603",2024-08-09,"TNHA-SD","TNHA","SD","21362315",231,1,116,230
"604",2024-08-10,"BEO-BASE","BEO","BASE","21390415",422,1,211.5,421
"605",2024-08-10,"SSMH-BASE","SSMH","BASE","21390413",213,1,107,212
"606",2024-08-10,"SSMH-SA","SSMH","SA","21398622",471,1,236,470
"607",2024-08-10,"SSMH-SB","SSMH","SB","21362319",361,1,181,360
"608",2024-08-10,"SSMH-SI","SSMH","SI","21398619",194,1,97.5,193
"609",2024-08-10,"TNHA-BASE","TNHA","BASE","21176526",543,1,272,542
"610",2024-08-10,"TNHA-SA","TNHA","SA","21398620",531,1,266,530
"611",2024-08-10,"TNHA-SB","TNHA","SB","21362318",393,1,197,392
"612",2024-08-10,"TNHA-SD","TNHA","SD","21362315",197,1,99,196
"613",2024-08-11,"BEO-BASE","BEO","BASE","21390415",788,1,394.5,787
"614",2024-08-11,"SSMH-BASE","SSMH","BASE","21390413",196,1,98.5,195
"615",2024-08-11,"SSMH-SA","SSMH","SA","21398622",362,1,181.5,361
"616",2024-08-11,"SSMH-SB","SSMH","SB","21362319",247,1,124,246
"617",2024-08-11,"SSMH-SI","SSMH","SI","21398619",177,1,89,176
"618",2024-08-11,"TNHA-BASE","TNHA","BASE","21176526",213,1,107,212
"619",2024-08-11,"TNHA-SA","TNHA","SA","21398620",437,1,219,436
"620",2024-08-11,"TNHA-SB","TNHA","SB","21362318",352,1,176.5,351
"621",2024-08-11,"TNHA-SD","TNHA","SD","21362315",147,1,74,146
"622",2024-08-12,"BEO-BASE","BEO","BASE","21390415",576,1,288.5,575
"623",2024-08-12,"SSMH-BASE","SSMH","BASE","21390413",423,1,212,422
"624",2024-08-12,"SSMH-SA","SSMH","SA","21398622",452,1,226.5,451
"625",2024-08-12,"SSMH-SB","SSMH","SB","21362319",423,1,212,422
"626",2024-08-12,"SSMH-SI","SSMH","SI","21398619",304,1,152.5,303
"627",2024-08-12,"TNHA-BASE","TNHA","BASE","21176526",479,1,240,478
"628",2024-08-12,"TNHA-SA","TNHA","SA","21398620",539,1,270,538
"629",2024-08-12,"TNHA-SB","TNHA","SB","21362318",346,1,173.5,345
"630",2024-08-12,"TNHA-SD","TNHA","SD","21362315",234,1,117.5,233
"631",2024-08-13,"BEO-BASE","BEO","BASE","21390415",438,1,219.5,437
"632",2024-08-13,"SSMH-BASE","SSMH","BASE","21390413",219,1,110,218
"633",2024-08-13,"SSMH-SA","SSMH","SA","21398622",239,1,120,238
"634",2024-08-13,"SSMH-SB","SSMH","SB","21362319",179,1,90,178
"635",2024-08-13,"SSMH-SI","SSMH","SI","21398619",191,1,96,190
"636",2024-08-13,"TNHA-BASE","TNHA","BASE","21176526",261,1,131,260
"637",2024-08-13,"TNHA-SA","TNHA","SA","21398620",207,1,104,206
"638",2024-08-13,"TNHA-SB","TNHA","SB","21362318",247,1,124,246
"639",2024-08-13,"TNHA-SD","TNHA","SD","21362315",192,1,96.5,191
"640",2024-08-14,"BEO-BASE","BEO","BASE","21390415",198,1,99.5,197
"641",2024-08-14,"SSMH-BASE","SSMH","BASE","21390413",179,1,90,178
"642",2024-08-14,"SSMH-SA","SSMH","SA","21398622",144,1,72.5,143
"643",2024-08-14,"SSMH-SB","SSMH","SB","21362319",106,1,53.5,105
"644",2024-08-14,"SSMH-SI","SSMH","SI","21398619",127,1,64,126
"645",2024-08-14,"TNHA-BASE","TNHA","BASE","21176526",173,1,87,172
"646",2024-08-14,"TNHA-SA","TNHA","SA","21398620",84,1,42.5,83
"647",2024-08-14,"TNHA-SB","TNHA","SB","21362318",148,1,74.5,147
"648",2024-08-14,"TNHA-SD","TNHA","SD","21362315",88,1,44.5,87
"649",2024-08-15,"BEO-BASE","BEO","BASE","21390415",731,1,366,730
"650",2024-08-15,"SSMH-BASE","SSMH","BASE","21390413",351,1,176,350
"651",2024-08-15,"SSMH-SA","SSMH","SA","21398622",466,1,233.5,465
"652",2024-08-15,"SSMH-SB","SSMH","SB","21362319",323,1,162,322
"653",2024-08-15,"SSMH-SI","SSMH","SI","21398619",181,1,91,180
"654",2024-08-15,"TNHA-BASE","TNHA","BASE","21176526",358,1,179.5,357
"655",2024-08-15,"TNHA-SA","TNHA","SA","21398620",453,1,227,452
"656",2024-08-15,"TNHA-SB","TNHA","SB","21362318",354,1,177.5,353
"657",2024-08-15,"TNHA-SD","TNHA","SD","21362315",178,1,89.5,177
"658",2024-08-16,"BEO-BASE","BEO","BASE","21390415",317,1,159,316
"659",2024-08-16,"SSMH-BASE","SSMH","BASE","21390413",116,1,58.5,115
"660",2024-08-16,"SSMH-SA","SSMH","SA","21398622",527,1,264,526
"661",2024-08-16,"SSMH-SB","SSMH","SB","21362319",441,1,221,440
"662",2024-08-16,"SSMH-SI","SSMH","SI","21398619",314,1,157.5,313
"663",2024-08-16,"TNHA-BASE","TNHA","BASE","21176526",539,1,270,538
"664",2024-08-16,"TNHA-SA","TNHA","SA","21398620",669,1,335,668
"665",2024-08-16,"TNHA-SB","TNHA","SB","21362318",414,1,207.5,413
"666",2024-08-16,"TNHA-SD","TNHA","SD","21362315",88,1,44.5,87
"667",2024-08-17,"BEO-BASE","BEO","BASE","21390415",639,1,320,638
"668",2024-08-17,"SSMH-BASE","SSMH","BASE","21390413",282,1,141.5,281
"669",2024-08-17,"SSMH-SA","SSMH","SA","21398622",333,1,167,332
"670",2024-08-17,"SSMH-SB","SSMH","SB","21362319",236,1,118.5,235
"671",2024-08-17,"SSMH-SI","SSMH","SI","21398619",212,1,106.5,211
"672",2024-08-17,"TNHA-BASE","TNHA","BASE","21176526",294,1,147.5,293
"673",2024-08-17,"TNHA-SA","TNHA","SA","21398620",313,1,157,312
"674",2024-08-17,"TNHA-SB","TNHA","SB","21362318",282,1,141.5,281
"675",2024-08-17,"TNHA-SD","TNHA","SD","21362315",266,1,133.5,265
"676",2024-08-18,"BEO-BASE","BEO","BASE","21390415",527,1,264,526
"677",2024-08-18,"SSMH-BASE","SSMH","BASE","21390413",179,1,90,178
"678",2024-08-18,"SSMH-SA","SSMH","SA","21398622",489,1,245,488
"679",2024-08-18,"SSMH-SB","SSMH","SB","21362319",412,1,206.5,411
"680",2024-08-18,"SSMH-SI","SSMH","SI","21398619",267,1,134,266
"681",2024-08-18,"TNHA-BASE","TNHA","BASE","21176526",317,1,159,316
"682",2024-08-18,"TNHA-SA","TNHA","SA","21398620",598,1,299.5,597
"683",2024-08-18,"TNHA-SB","TNHA","SB","21362318",383,1,192,382
"684",2024-08-18,"TNHA-SD","TNHA","SD","21362315",88,1,44.5,87
"685",2024-08-19,"BEO-BASE","BEO","BASE","21390415",221,1,111,220
"686",2024-08-19,"SSMH-BASE","SSMH","BASE","21390413",178,1,89.5,177
"687",2024-08-19,"SSMH-SA","SSMH","SA","21398622",172,1,86.5,171
"688",2024-08-19,"SSMH-SB","SSMH","SB","21362319",122,1,61.5,121
"689",2024-08-19,"SSMH-SI","SSMH","SI","21398619",142,1,71.5,141
"690",2024-08-19,"TNHA-BASE","TNHA","BASE","21176526",199,1,100,198
"691",2024-08-19,"TNHA-SA","TNHA","SA","21398620",102,1,51.5,101
"692",2024-08-19,"TNHA-SB","TNHA","SB","21362318",167,1,84,166
"693",2024-08-19,"TNHA-SD","TNHA","SD","21362315",108,1,54.5,107
"694",2024-08-20,"BEO-BASE","BEO","BASE","21390415",369,1,185,368
"695",2024-08-20,"SSMH-BASE","SSMH","BASE","21390413",539,1,270,538
"696",2024-08-20,"SSMH-SA","SSMH","SA","21398622",388,1,194.5,387
"697",2024-08-20,"SSMH-SB","SSMH","SB","21362319",277,1,139,276
"698",2024-08-20,"SSMH-SI","SSMH","SI","21398619",257,1,129,256
"699",2024-08-20,"TNHA-BASE","TNHA","BASE","21176526",444,1,222.5,443
"700",2024-08-20,"TNHA-SA","TNHA","SA","21398620",324,1,162.5,323
"701",2024-08-20,"TNHA-SB","TNHA","SB","21362318",282,1,141.5,281
"702",2024-08-20,"TNHA-SD","TNHA","SD","21362315",261,1,131,260
"703",2024-08-21,"BEO-BASE","BEO","BASE","21390415",259,1,130,258
"704",2024-08-21,"SSMH-BASE","SSMH","BASE","21390413",147,1,74,146
"705",2024-08-21,"SSMH-SA","SSMH","SA","21398622",359,1,180,358
"706",2024-08-21,"SSMH-SB","SSMH","SB","21362319",277,1,139,276
"707",2024-08-21,"SSMH-SI","SSMH","SI","21398619",191,1,96,190
"708",2024-08-21,"TNHA-BASE","TNHA","BASE","21176526",147,1,74,146
"709",2024-08-21,"TNHA-SA","TNHA","SA","21398620",344,1,172.5,343
"710",2024-08-21,"TNHA-SB","TNHA","SB","21362318",286,1,143.5,285
"711",2024-08-21,"TNHA-SD","TNHA","SD","21362315",108,1,54.5,107
"712",2024-08-22,"BEO-BASE","BEO","BASE","21390415",367,1,184,366
"713",2024-08-22,"SSMH-BASE","SSMH","BASE","21390413",161,1,81,160
"714",2024-08-22,"SSMH-SA","SSMH","SA","21398622",197,1,99,196
"715",2024-08-22,"SSMH-SB","SSMH","SB","21362319",126,1,63.5,125
"716",2024-08-22,"SSMH-SI","SSMH","SI","21398619",173,1,87,172
"717",2024-08-22,"TNHA-BASE","TNHA","BASE","21176526",181,1,91,180
"718",2024-08-22,"TNHA-SA","TNHA","SA","21398620",116,1,58.5,115
"719",2024-08-22,"TNHA-SB","TNHA","SB","21362318",187,1,94,186
"720",2024-08-22,"TNHA-SD","TNHA","SD","21362315",132,1,66.5,131
"721",2024-08-23,"BEO-BASE","BEO","BASE","21390415",303,1,152,302
"722",2024-08-23,"SSMH-BASE","SSMH","BASE","21390413",168,1,84.5,167
"723",2024-08-23,"SSMH-SA","SSMH","SA","21398622",206,1,103.5,205
"724",2024-08-23,"SSMH-SB","SSMH","SB","21362319",128,1,64.5,127
"725",2024-08-23,"SSMH-SI","SSMH","SI","21398619",176,1,88.5,175
"726",2024-08-23,"TNHA-BASE","TNHA","BASE","21176526",171,1,86,170
"727",2024-08-23,"TNHA-SA","TNHA","SA","21398620",142,1,71.5,141
"728",2024-08-23,"TNHA-SB","TNHA","SB","21362318",184,1,92.5,183
"729",2024-08-23,"TNHA-SD","TNHA","SD","21362315",157,1,79,156
"730",2024-08-24,"BEO-BASE","BEO","BASE","21390415",141,1,71,140
"731",2024-08-24,"SSMH-BASE","SSMH","BASE","21390413",107,1,54,106
"732",2024-08-24,"SSMH-SA","SSMH","SA","21398622",142,1,71.5,141
"733",2024-08-24,"SSMH-SB","SSMH","SB","21362319",103,1,52,102
"734",2024-08-24,"SSMH-SI","SSMH","SI","21398619",124,1,62.5,123
"735",2024-08-24,"TNHA-BASE","TNHA","BASE","21176526",109,1,55,108
"736",2024-08-24,"TNHA-SA","TNHA","SA","21398620",84,1,42.5,83
"737",2024-08-24,"TNHA-SB","TNHA","SB","21362318",144,1,72.5,143
"738",2024-08-24,"TNHA-SD","TNHA","SD","21362315",87,1,44,86
"739",2024-08-25,"BEO-BASE","BEO","BASE","21390415",304,1,152.5,303
"740",2024-08-25,"SSMH-BASE","SSMH","BASE","21390413",182,1,91.5,181
"741",2024-08-25,"SSMH-SA","SSMH","SA","21398622",328,1,164.5,327
"742",2024-08-25,"SSMH-SB","SSMH","SB","21362319",223,1,112,222
"743",2024-08-25,"SSMH-SI","SSMH","SI","21398619",153,1,77,152
"744",2024-08-25,"TNHA-BASE","TNHA","BASE","21176526",249,1,125,248
"745",2024-08-25,"TNHA-SA","TNHA","SA","21398620",309,1,155,308
"746",2024-08-25,"TNHA-SB","TNHA","SB","21362318",248,1,124.5,247
"747",2024-08-25,"TNHA-SD","TNHA","SD","21362315",132,1,66.5,131
"748",2024-08-26,"BEO-BASE","BEO","BASE","21390415",446,1,223.5,445
"749",2024-08-26,"SSMH-BASE","SSMH","BASE","21390413",509,1,255,508
"750",2024-08-26,"SSMH-SA","SSMH","SA","21398622",416,1,208.5,415
"751",2024-08-26,"SSMH-SB","SSMH","SB","21362319",224,1,112.5,223
"752",2024-08-26,"SSMH-SI","SSMH","SI","21398619",294,1,147.5,293
"753",2024-08-26,"TNHA-BASE","TNHA","BASE","21176526",314,1,157.5,313
"754",2024-08-26,"TNHA-SA","TNHA","SA","21398620",422,1,211.5,421
"755",2024-08-26,"TNHA-SB","TNHA","SB","21362318",312,1,156.5,311
"756",2024-08-26,"TNHA-SD","TNHA","SD","21362315",367,1,184,366
"757",2024-08-27,"BEO-BASE","BEO","BASE","21390415",517,1,259,516
"758",2024-08-27,"SSMH-BASE","SSMH","BASE","21390413",634,1,317.5,633
"759",2024-08-27,"SSMH-SA","SSMH","SA","21398622",519,1,260,518
"760",2024-08-27,"SSMH-SB","SSMH","SB","21362319",352,1,176.5,351
"761",2024-08-27,"SSMH-SI","SSMH","SI","21398619",228,1,114.5,227
"762",2024-08-27,"TNHA-BASE","TNHA","BASE","21176526",459,1,230,458
"763",2024-08-27,"TNHA-SA","TNHA","SA","21398620",629,1,315,628
"764",2024-08-27,"TNHA-SB","TNHA","SB","21362318",358,1,179.5,357
"765",2024-08-27,"TNHA-SD","TNHA","SD","21362315",386,1,193.5,385
"766",2024-08-28,"BEO-BASE","BEO","BASE","21390415",436,1,218.5,435
"767",2024-08-28,"SSMH-BASE","SSMH","BASE","21390413",154,1,77.5,153
"768",2024-08-28,"SSMH-SA","SSMH","SA","21398622",489,1,245,488
"769",2024-08-28,"SSMH-SB","SSMH","SB","21362319",417,1,209,416
"770",2024-08-28,"SSMH-SI","SSMH","SI","21398619",277,1,139,276
"771",2024-08-28,"TNHA-BASE","TNHA","BASE","21176526",512,1,256.5,511
"772",2024-08-28,"TNHA-SA","TNHA","SA","21398620",627,1,314,626
"773",2024-08-28,"TNHA-SB","TNHA","SB","21362318",347,1,174,346
"774",2024-08-28,"TNHA-SD","TNHA","SD","21362315",86,1,43.5,85
"775",2024-08-29,"BEO-BASE","BEO","BASE","21390415",234,1,117.5,233
"776",2024-08-29,"SSMH-BASE","SSMH","BASE","21390413",132,1,66.5,131
"777",2024-08-29,"SSMH-SA","SSMH","SA","21398622",144,1,72.5,143
"778",2024-08-29,"SSMH-SB","SSMH","SB","21362319",131,1,66,130
"779",2024-08-29,"SSMH-SI","SSMH","SI","21398619",119,1,60,118
"780",2024-08-29,"TNHA-BASE","TNHA","BASE","21176526",114,1,57.5,113
"781",2024-08-29,"TNHA-SA","TNHA","SA","21398620",127,1,64,126
"782",2024-08-29,"TNHA-SB","TNHA","SB","21362318",164,1,82.5,163
"783",2024-08-29,"TNHA-SD","TNHA","SD","21362315",78,1,39.5,77
"784",2024-08-30,"BEO-BASE","BEO","BASE","21390415",332,1,166.5,331
"785",2024-08-30,"SSMH-BASE","SSMH","BASE","21390413",232,1,116.5,231
"786",2024-08-30,"SSMH-SA","SSMH","SA","21398622",192,1,96.5,191
"787",2024-08-30,"SSMH-SB","SSMH","SB","21362319",139,1,70,138
"788",2024-08-30,"SSMH-SI","SSMH","SI","21398619",156,1,78.5,155
"789",2024-08-30,"TNHA-BASE","TNHA","BASE","21176526",222,1,111.5,221
"790",2024-08-30,"TNHA-SA","TNHA","SA","21398620",121,1,61,120
"791",2024-08-30,"TNHA-SB","TNHA","SB","21362318",176,1,88.5,175
"792",2024-08-30,"TNHA-SD","TNHA","SD","21362315",108,1,54.5,107
"793",2024-08-31,"SSMH-BASE","SSMH","BASE","21390413",162,162,162,0
"794",2024-08-31,"SSMH-SA","SSMH","SA","21398622",326,326,326,0
"795",2024-08-31,"SSMH-SB","SSMH","SB","21362319",236,236,236,0
"796",2024-08-31,"SSMH-SI","SSMH","SI","21398619",166,166,166,0
"797",2024-08-31,"TNHA-BASE","TNHA","BASE","21176526",169,169,169,0
"798",2024-08-31,"TNHA-SA","TNHA","SA","21398620",304,304,304,0
"799",2024-08-31,"TNHA-SB","TNHA","SB","21362318",257,257,257,0
"800",2024-08-31,"TNHA-SD","TNHA","SD","21362315",109,109,109,0
