"","Date","fullname","site","station","sensor","max","min","avg","amp"
"1",2024-03-11,"TNHA-BASE","TNHA","BASE","21176526",174,158,166,16
"2",2024-03-11,"TNHA-SA","TNHA","SA","21398620",437,327,382,110
"3",2024-03-11,"TNHA-SB","TNHA","SB","21362318",333,312,322.5,21
"4",2024-03-11,"TNHA-SC","TNHA","SC","21362317",37,34,35.5,3
"5",2024-03-11,"TNHA-SD","TNHA","SD","21362315",297,109,203,188
"6",2024-03-12,"SSMH-SA","SSMH","SA","21398622",306,304,305,2
"7",2024-03-12,"SSMH-SB","SSMH","SB","21362319",41,36,38.5,5
"8",2024-03-12,"TNHA-BASE","TNHA","BASE","21176526",191,1,96,190
"9",2024-03-12,"TNHA-SA","TNHA","SA","21398620",447,1,224,446
"10",2024-03-12,"TNHA-SB","TNHA","SB","21362318",327,1,164,326
"11",2024-03-12,"TNHA-SC","TNHA","SC","21362317",37,1,19,36
"12",2024-03-12,"TNHA-SD","TNHA","SD","21362315",303,1,152,302
"13",2024-03-13,"SSMH-SA","SSMH","SA","21398622",307,1,154,306
"14",2024-03-13,"SSMH-SB","SSMH","SB","21362319",56,1,28.5,55
"15",2024-03-13,"SSMH-SI","SSMH","SI","21398619",237,72,154.5,165
"16",2024-03-13,"TNHA-BASE","TNHA","BASE","21176526",194,1,97.5,193
"17",2024-03-13,"TNHA-SA","TNHA","SA","21398620",422,1,211.5,421
"18",2024-03-13,"TNHA-SB","TNHA","SB","21362318",229,1,115,228
"19",2024-03-13,"TNHA-SC","TNHA","SC","21362317",41,1,21,40
"20",2024-03-13,"TNHA-SD","TNHA","SD","21362315",348,1,174.5,347
"21",2024-03-14,"SSMH-SA","SSMH","SA","21398622",323,1,162,322
"22",2024-03-14,"SSMH-SB","SSMH","SB","21362319",74,1,37.5,73
"23",2024-03-14,"SSMH-SI","SSMH","SI","21398619",227,1,114,226
"24",2024-03-14,"TNHA-BASE","TNHA","BASE","21176526",222,1,111.5,221
"25",2024-03-14,"TNHA-SA","TNHA","SA","21398620",473,1,237,472
"26",2024-03-14,"TNHA-SB","TNHA","SB","21362318",241,1,121,240
"27",2024-03-14,"TNHA-SC","TNHA","SC","21362317",44,1,22.5,43
"28",2024-03-14,"TNHA-SD","TNHA","SD","21362315",358,1,179.5,357
"29",2024-03-15,"SSMH-SA","SSMH","SA","21398622",323,1,162,322
"30",2024-03-15,"SSMH-SB","SSMH","SB","21362319",82,1,41.5,81
"31",2024-03-15,"SSMH-SI","SSMH","SI","21398619",228,1,114.5,227
"32",2024-03-15,"TNHA-BASE","TNHA","BASE","21176526",322,1,161.5,321
"33",2024-03-15,"TNHA-SA","TNHA","SA","21398620",486,1,243.5,485
"34",2024-03-15,"TNHA-SB","TNHA","SB","21362318",251,1,126,250
"35",2024-03-15,"TNHA-SC","TNHA","SC","21362317",32,1,16.5,31
"36",2024-03-15,"TNHA-SD","TNHA","SD","21362315",369,1,185,368
"37",2024-03-16,"SSMH-SA","SSMH","SA","21398622",343,1,172,342
"38",2024-03-16,"SSMH-SB","SSMH","SB","21362319",87,1,44,86
"39",2024-03-16,"SSMH-SI","SSMH","SI","21398619",248,1,124.5,247
"40",2024-03-16,"TNHA-BASE","TNHA","BASE","21176526",333,1,167,332
"41",2024-03-16,"TNHA-SA","TNHA","SA","21398620",508,1,254.5,507
"42",2024-03-16,"TNHA-SB","TNHA","SB","21362318",251,1,126,250
"43",2024-03-16,"TNHA-SC","TNHA","SC","21362317",32,1,16.5,31
"44",2024-03-16,"TNHA-SD","TNHA","SD","21362315",382,1,191.5,381
"45",2024-03-17,"SSMH-SA","SSMH","SA","21398622",334,1,167.5,333
"46",2024-03-17,"SSMH-SB","SSMH","SB","21362319",98,1,49.5,97
"47",2024-03-17,"SSMH-SI","SSMH","SI","21398619",264,1,132.5,263
"48",2024-03-17,"TNHA-BASE","TNHA","BASE","21176526",318,1,159.5,317
"49",2024-03-17,"TNHA-SA","TNHA","SA","21398620",512,1,256.5,511
"50",2024-03-17,"TNHA-SB","TNHA","SB","21362318",223,1,112,222
"51",2024-03-17,"TNHA-SC","TNHA","SC","21362317",33,1,17,32
"52",2024-03-17,"TNHA-SD","TNHA","SD","21362315",384,1,192.5,383
"53",2024-03-18,"SSMH-SA","SSMH","SA","21398622",302,1,151.5,301
"54",2024-03-18,"SSMH-SB","SSMH","SB","21362319",98,1,49.5,97
"55",2024-03-18,"SSMH-SI","SSMH","SI","21398619",162,1,81.5,161
"56",2024-03-18,"TNHA-BASE","TNHA","BASE","21176526",336,1,168.5,335
"57",2024-03-18,"TNHA-SA","TNHA","SA","21398620",424,1,212.5,423
"58",2024-03-18,"TNHA-SB","TNHA","SB","21362318",218,1,109.5,217
"59",2024-03-18,"TNHA-SC","TNHA","SC","21362317",93,1,47,92
"60",2024-03-18,"TNHA-SD","TNHA","SD","21362315",96,1,48.5,95
"61",2024-03-19,"SSMH-SA","SSMH","SA","21398622",334,1,167.5,333
"62",2024-03-19,"SSMH-SB","SSMH","SB","21362319",98,1,49.5,97
"63",2024-03-19,"SSMH-SI","SSMH","SI","21398619",236,1,118.5,235
"64",2024-03-19,"TNHA-BASE","TNHA","BASE","21176526",332,1,166.5,331
"65",2024-03-19,"TNHA-SA","TNHA","SA","21398620",457,1,229,456
"66",2024-03-19,"TNHA-SB","TNHA","SB","21362318",252,1,126.5,251
"67",2024-03-19,"TNHA-SC","TNHA","SC","21362317",102,1,51.5,101
"68",2024-03-19,"TNHA-SD","TNHA","SD","21362315",337,1,169,336
"69",2024-03-20,"SSMH-SA","SSMH","SA","21398622",216,1,108.5,215
"70",2024-03-20,"SSMH-SB","SSMH","SB","21362319",56,1,28.5,55
"71",2024-03-20,"SSMH-SI","SSMH","SI","21398619",134,1,67.5,133
"72",2024-03-20,"TNHA-BASE","TNHA","BASE","21176526",182,1,91.5,181
"73",2024-03-20,"TNHA-SA","TNHA","SA","21398620",281,1,141,280
"74",2024-03-20,"TNHA-SB","TNHA","SB","21362318",164,1,82.5,163
"75",2024-03-20,"TNHA-SC","TNHA","SC","21362317",83,1,42,82
"76",2024-03-20,"TNHA-SD","TNHA","SD","21362315",97,1,49,96
"77",2024-03-21,"SSMH-SA","SSMH","SA","21398622",199,1,100,198
"78",2024-03-21,"SSMH-SB","SSMH","SB","21362319",67,1,34,66
"79",2024-03-21,"SSMH-SI","SSMH","SI","21398619",153,1,77,152
"80",2024-03-21,"TNHA-BASE","TNHA","BASE","21176526",182,1,91.5,181
"81",2024-03-21,"TNHA-SA","TNHA","SA","21398620",251,1,126,250
"82",2024-03-21,"TNHA-SB","TNHA","SB","21362318",182,1,91.5,181
"83",2024-03-21,"TNHA-SC","TNHA","SC","21362317",106,1,53.5,105
"84",2024-03-21,"TNHA-SD","TNHA","SD","21362315",166,1,83.5,165
"85",2024-03-22,"SSMH-SA","SSMH","SA","21398622",372,1,186.5,371
"86",2024-03-22,"SSMH-SB","SSMH","SB","21362319",72,1,36.5,71
"87",2024-03-22,"SSMH-SI","SSMH","SI","21398619",196,1,98.5,195
"88",2024-03-22,"TNHA-BASE","TNHA","BASE","21176526",422,1,211.5,421
"89",2024-03-22,"TNHA-SA","TNHA","SA","21398620",501,1,251,500
"90",2024-03-22,"TNHA-SB","TNHA","SB","21362318",251,1,126,250
"91",2024-03-22,"TNHA-SC","TNHA","SC","21362317",93,1,47,92
"92",2024-03-22,"TNHA-SD","TNHA","SD","21362315",419,1,210,418
"93",2024-03-23,"SSMH-SA","SSMH","SA","21398622",202,1,101.5,201
"94",2024-03-23,"SSMH-SB","SSMH","SB","21362319",111,1,56,110
"95",2024-03-23,"SSMH-SI","SSMH","SI","21398619",161,1,81,160
"96",2024-03-23,"TNHA-BASE","TNHA","BASE","21176526",474,1,237.5,473
"97",2024-03-23,"TNHA-SA","TNHA","SA","21398620",192,1,96.5,191
"98",2024-03-23,"TNHA-SB","TNHA","SB","21362318",197,1,99,196
"99",2024-03-23,"TNHA-SC","TNHA","SC","21362317",114,1,57.5,113
"100",2024-03-23,"TNHA-SD","TNHA","SD","21362315",123,1,62,122
"101",2024-03-24,"SSMH-SA","SSMH","SA","21398622",237,1,119,236
"102",2024-03-24,"SSMH-SB","SSMH","SB","21362319",128,1,64.5,127
"103",2024-03-24,"SSMH-SI","SSMH","SI","21398619",186,1,93.5,185
"104",2024-03-24,"TNHA-BASE","TNHA","BASE","21176526",231,1,116,230
"105",2024-03-24,"TNHA-SA","TNHA","SA","21398620",197,1,99,196
"106",2024-03-24,"TNHA-SB","TNHA","SB","21362318",226,1,113.5,225
"107",2024-03-24,"TNHA-SC","TNHA","SC","21362317",131,1,66,130
"108",2024-03-24,"TNHA-SD","TNHA","SD","21362315",177,1,89,176
"109",2024-03-25,"SSMH-SA","SSMH","SA","21398622",167,1,84,166
"110",2024-03-25,"SSMH-SB","SSMH","SB","21362319",93,1,47,92
"111",2024-03-25,"SSMH-SI","SSMH","SI","21398619",237,1,119,236
"112",2024-03-25,"TNHA-BASE","TNHA","BASE","21176526",327,1,164,326
"113",2024-03-25,"TNHA-SA","TNHA","SA","21398620",334,1,167.5,333
"114",2024-03-25,"TNHA-SB","TNHA","SB","21362318",202,1,101.5,201
"115",2024-03-25,"TNHA-SC","TNHA","SC","21362317",114,1,57.5,113
"116",2024-03-25,"TNHA-SD","TNHA","SD","21362315",342,1,171.5,341
"117",2024-03-26,"SSMH-SA","SSMH","SA","21398622",329,1,165,328
"118",2024-03-26,"SSMH-SB","SSMH","SB","21362319",96,1,48.5,95
"119",2024-03-26,"SSMH-SI","SSMH","SI","21398619",306,1,153.5,305
"120",2024-03-26,"TNHA-BASE","TNHA","BASE","21176526",387,1,194,386
"121",2024-03-26,"TNHA-SA","TNHA","SA","21398620",519,1,260,518
"122",2024-03-26,"TNHA-SB","TNHA","SB","21362318",268,1,134.5,267
"123",2024-03-26,"TNHA-SC","TNHA","SC","21362317",93,1,47,92
"124",2024-03-26,"TNHA-SD","TNHA","SD","21362315",449,1,225,448
"125",2024-03-27,"SSMH-SA","SSMH","SA","21398622",336,1,168.5,335
"126",2024-03-27,"SSMH-SB","SSMH","SB","21362319",149,1,75,148
"127",2024-03-27,"SSMH-SI","SSMH","SI","21398619",218,1,109.5,217
"128",2024-03-27,"TNHA-BASE","TNHA","BASE","21176526",323,1,162,322
"129",2024-03-27,"TNHA-SA","TNHA","SA","21398620",514,1,257.5,513
"130",2024-03-27,"TNHA-SB","TNHA","SB","21362318",287,1,144,286
"131",2024-03-27,"TNHA-SC","TNHA","SC","21362317",128,1,64.5,127
"132",2024-03-27,"TNHA-SD","TNHA","SD","21362315",269,1,135,268
"133",2024-03-28,"SSMH-SA","SSMH","SA","21398622",244,1,122.5,243
"134",2024-03-28,"SSMH-SB","SSMH","SB","21362319",153,1,77,152
"135",2024-03-28,"SSMH-SI","SSMH","SI","21398619",216,1,108.5,215
"136",2024-03-28,"TNHA-BASE","TNHA","BASE","21176526",228,1,114.5,227
"137",2024-03-28,"TNHA-SA","TNHA","SA","21398620",243,1,122,242
"138",2024-03-28,"TNHA-SB","TNHA","SB","21362318",243,1,122,242
"139",2024-03-28,"TNHA-SC","TNHA","SC","21362317",161,1,81,160
"140",2024-03-28,"TNHA-SD","TNHA","SD","21362315",167,1,84,166
"141",2024-03-29,"SSMH-SA","SSMH","SA","21398622",203,1,102,202
"142",2024-03-29,"SSMH-SB","SSMH","SB","21362319",151,1,76,150
"143",2024-03-29,"SSMH-SI","SSMH","SI","21398619",189,1,95,188
"144",2024-03-29,"TNHA-BASE","TNHA","BASE","21176526",288,1,144.5,287
"145",2024-03-29,"TNHA-SA","TNHA","SA","21398620",143,1,72,142
"146",2024-03-29,"TNHA-SB","TNHA","SB","21362318",227,1,114,226
"147",2024-03-29,"TNHA-SC","TNHA","SC","21362317",164,1,82.5,163
"148",2024-03-29,"TNHA-SD","TNHA","SD","21362315",143,1,72,142
"149",2024-03-30,"SSMH-SA","SSMH","SA","21398622",206,1,103.5,205
"150",2024-03-30,"SSMH-SB","SSMH","SB","21362319",159,1,80,158
"151",2024-03-30,"SSMH-SI","SSMH","SI","21398619",191,1,96,190
"152",2024-03-30,"TNHA-BASE","TNHA","BASE","21176526",221,1,111,220
"153",2024-03-30,"TNHA-SA","TNHA","SA","21398620",149,1,75,148
"154",2024-03-30,"TNHA-SB","TNHA","SB","21362318",236,1,118.5,235
"155",2024-03-30,"TNHA-SC","TNHA","SC","21362317",171,1,86,170
"156",2024-03-30,"TNHA-SD","TNHA","SD","21362315",147,1,74,146
"157",2024-03-31,"SSMH-SA","SSMH","SA","21398622",199,1,100,198
"158",2024-03-31,"SSMH-SB","SSMH","SB","21362319",156,1,78.5,155
"159",2024-03-31,"SSMH-SI","SSMH","SI","21398619",177,1,89,176
"160",2024-03-31,"TNHA-BASE","TNHA","BASE","21176526",218,1,109.5,217
"161",2024-03-31,"TNHA-SA","TNHA","SA","21398620",147,1,74,146
"162",2024-03-31,"TNHA-SB","TNHA","SB","21362318",214,1,107.5,213
"163",2024-03-31,"TNHA-SC","TNHA","SC","21362317",147,1,74,146
"164",2024-03-31,"TNHA-SD","TNHA","SD","21362315",126,1,63.5,125
"165",2024-04-01,"SSMH-SA","SSMH","SA","21398622",253,1,127,252
"166",2024-04-01,"SSMH-SB","SSMH","SB","21362319",152,1,76.5,151
"167",2024-04-01,"SSMH-SI","SSMH","SI","21398619",221,1,111,220
"168",2024-04-01,"TNHA-BASE","TNHA","BASE","21176526",197,1,99,196
"169",2024-04-01,"TNHA-SA","TNHA","SA","21398620",209,1,105,208
"170",2024-04-01,"TNHA-SB","TNHA","SB","21362318",228,1,114.5,227
"171",2024-04-01,"TNHA-SC","TNHA","SC","21362317",138,1,69.5,137
"172",2024-04-01,"TNHA-SD","TNHA","SD","21362315",187,1,94,186
"173",2024-04-02,"SSMH-SA","SSMH","SA","21398622",422,1,211.5,421
"174",2024-04-02,"SSMH-SB","SSMH","SB","21362319",191,1,96,190
"175",2024-04-02,"SSMH-SI","SSMH","SI","21398619",319,1,160,318
"176",2024-04-02,"TNHA-BASE","TNHA","BASE","21176526",187,1,94,186
"177",2024-04-02,"TNHA-SA","TNHA","SA","21398620",468,1,234.5,467
"178",2024-04-02,"TNHA-SB","TNHA","SB","21362318",347,1,174,346
"179",2024-04-02,"TNHA-SC","TNHA","SC","21362317",168,1,84.5,167
"180",2024-04-02,"TNHA-SD","TNHA","SD","21362315",207,1,104,206
"181",2024-04-03,"SSMH-SA","SSMH","SA","21398622",367,1,184,366
"182",2024-04-03,"SSMH-SB","SSMH","SB","21362319",238,1,119.5,237
"183",2024-04-03,"SSMH-SI","SSMH","SI","21398619",241,1,121,240
"184",2024-04-03,"TNHA-BASE","TNHA","BASE","21176526",184,1,92.5,183
"185",2024-04-03,"TNHA-SA","TNHA","SA","21398620",416,1,208.5,415
"186",2024-04-03,"TNHA-SB","TNHA","SB","21362318",318,1,159.5,317
"187",2024-04-03,"TNHA-SC","TNHA","SC","21362317",164,1,82.5,163
"188",2024-04-03,"TNHA-SD","TNHA","SD","21362315",182,1,91.5,181
"189",2024-04-04,"SSMH-SA","SSMH","SA","21398622",388,1,194.5,387
"190",2024-04-04,"SSMH-SB","SSMH","SB","21362319",243,1,122,242
"191",2024-04-04,"SSMH-SI","SSMH","SI","21398619",304,1,152.5,303
"192",2024-04-04,"TNHA-BASE","TNHA","BASE","21176526",336,1,168.5,335
"193",2024-04-04,"TNHA-SA","TNHA","SA","21398620",397,1,199,396
"194",2024-04-04,"TNHA-SB","TNHA","SB","21362318",336,1,168.5,335
"195",2024-04-04,"TNHA-SC","TNHA","SC","21362317",127,1,64,126
"196",2024-04-04,"TNHA-SD","TNHA","SD","21362315",371,1,186,370
"197",2024-04-05,"SSMH-SA","SSMH","SA","21398622",376,1,188.5,375
"198",2024-04-05,"SSMH-SB","SSMH","SB","21362319",292,1,146.5,291
"199",2024-04-05,"SSMH-SI","SSMH","SI","21398619",236,1,118.5,235
"200",2024-04-05,"TNHA-BASE","TNHA","BASE","21176526",303,1,152,302
"201",2024-04-05,"TNHA-SA","TNHA","SA","21398620",448,1,224.5,447
"202",2024-04-05,"TNHA-SB","TNHA","SB","21362318",336,1,168.5,335
"203",2024-04-05,"TNHA-SC","TNHA","SC","21362317",154,1,77.5,153
"204",2024-04-05,"TNHA-SD","TNHA","SD","21362315",253,1,127,252
"205",2024-04-06,"SSMH-SA","SSMH","SA","21398622",359,1,180,358
"206",2024-04-06,"SSMH-SB","SSMH","SB","21362319",103,1,52,102
"207",2024-04-06,"SSMH-SI","SSMH","SI","21398619",254,1,127.5,253
"208",2024-04-06,"TNHA-BASE","TNHA","BASE","21176526",436,1,218.5,435
"209",2024-04-06,"TNHA-SA","TNHA","SA","21398620",312,1,156.5,311
"210",2024-04-06,"TNHA-SB","TNHA","SB","21362318",343,1,172,342
"211",2024-04-06,"TNHA-SC","TNHA","SC","21362317",159,1,80,158
"212",2024-04-06,"TNHA-SD","TNHA","SD","21362315",231,1,116,230
"213",2024-04-07,"SSMH-SA","SSMH","SA","21398622",401,1,201,400
"214",2024-04-07,"SSMH-SB","SSMH","SB","21362319",77,1,39,76
"215",2024-04-07,"SSMH-SI","SSMH","SI","21398619",299,1,150,298
"216",2024-04-07,"TNHA-BASE","TNHA","BASE","21176526",358,1,179.5,357
"217",2024-04-07,"TNHA-SA","TNHA","SA","21398620",464,1,232.5,463
"218",2024-04-07,"TNHA-SB","TNHA","SB","21362318",332,1,166.5,331
"219",2024-04-07,"TNHA-SC","TNHA","SC","21362317",122,1,61.5,121
"220",2024-04-07,"TNHA-SD","TNHA","SD","21362315",231,1,116,230
"221",2024-04-08,"SSMH-SA","SSMH","SA","21398622",517,1,259,516
"222",2024-04-08,"SSMH-SB","SSMH","SB","21362319",121,1,61,120
"223",2024-04-08,"SSMH-SI","SSMH","SI","21398619",391,1,196,390
"224",2024-04-08,"TNHA-BASE","TNHA","BASE","21176526",491,1,246,490
"225",2024-04-08,"TNHA-SA","TNHA","SA","21398620",698,1,349.5,697
"226",2024-04-08,"TNHA-SB","TNHA","SB","21362318",376,1,188.5,375
"227",2024-04-08,"TNHA-SC","TNHA","SC","21362317",147,1,74,146
"228",2024-04-08,"TNHA-SD","TNHA","SD","21362315",497,1,249,496
"229",2024-04-09,"SSMH-SA","SSMH","SA","21398622",522,1,261.5,521
"230",2024-04-09,"SSMH-SB","SSMH","SB","21362319",233,1,117,232
"231",2024-04-09,"SSMH-SI","SSMH","SI","21398619",402,1,201.5,401
"232",2024-04-09,"TNHA-BASE","TNHA","BASE","21176526",491,1,246,490
"233",2024-04-09,"TNHA-SA","TNHA","SA","21398620",702,1,351.5,701
"234",2024-04-09,"TNHA-SB","TNHA","SB","21362318",382,1,191.5,381
"235",2024-04-09,"TNHA-SC","TNHA","SC","21362317",174,1,87.5,173
"236",2024-04-09,"TNHA-SD","TNHA","SD","21362315",571,1,286,570
"237",2024-04-10,"SSMH-SA","SSMH","SA","21398622",523,1,262,522
"238",2024-04-10,"SSMH-SB","SSMH","SB","21362319",247,1,124,246
"239",2024-04-10,"SSMH-SI","SSMH","SI","21398619",402,1,201.5,401
"240",2024-04-10,"TNHA-BASE","TNHA","BASE","21176526",493,1,247,492
"241",2024-04-10,"TNHA-SA","TNHA","SA","21398620",694,1,347.5,693
"242",2024-04-10,"TNHA-SB","TNHA","SB","21362318",383,1,192,382
"243",2024-04-10,"TNHA-SC","TNHA","SC","21362317",181,1,91,180
"244",2024-04-10,"TNHA-SD","TNHA","SD","21362315",571,1,286,570
"245",2024-04-11,"SSMH-SA","SSMH","SA","21398622",501,1,251,500
"246",2024-04-11,"SSMH-SB","SSMH","SB","21362319",282,1,141.5,281
"247",2024-04-11,"SSMH-SI","SSMH","SI","21398619",284,1,142.5,283
"248",2024-04-11,"TNHA-BASE","TNHA","BASE","21176526",487,1,244,486
"249",2024-04-11,"TNHA-SA","TNHA","SA","21398620",698,1,349.5,697
"250",2024-04-11,"TNHA-SB","TNHA","SB","21362318",373,1,187,372
"251",2024-04-11,"TNHA-SC","TNHA","SC","21362317",209,1,105,208
"252",2024-04-11,"TNHA-SD","TNHA","SD","21362315",252,1,126.5,251
"253",2024-04-12,"SSMH-SA","SSMH","SA","21398622",528,1,264.5,527
"254",2024-04-12,"SSMH-SB","SSMH","SB","21362319",332,1,166.5,331
"255",2024-04-12,"SSMH-SI","SSMH","SI","21398619",288,1,144.5,287
"256",2024-04-12,"TNHA-BASE","TNHA","BASE","21176526",511,1,256,510
"257",2024-04-12,"TNHA-SA","TNHA","SA","21398620",597,1,299,596
"258",2024-04-12,"TNHA-SB","TNHA","SB","21362318",382,1,191.5,381
"259",2024-04-12,"TNHA-SC","TNHA","SC","21362317",161,1,81,160
"260",2024-04-12,"TNHA-SD","TNHA","SD","21362315",374,1,187.5,373
"261",2024-04-13,"SSMH-SA","SSMH","SA","21398622",537,1,269,536
"262",2024-04-13,"SSMH-SB","SSMH","SB","21362319",454,1,227.5,453
"263",2024-04-13,"SSMH-SI","SSMH","SI","21398619",356,1,178.5,355
"264",2024-04-13,"TNHA-BASE","TNHA","BASE","21176526",524,1,262.5,523
"265",2024-04-13,"TNHA-SA","TNHA","SA","21398620",709,1,355,708
"266",2024-04-13,"TNHA-SB","TNHA","SB","21362318",387,1,194,386
"267",2024-04-13,"TNHA-SC","TNHA","SC","21362317",164,1,82.5,163
"268",2024-04-13,"TNHA-SD","TNHA","SD","21362315",468,1,234.5,467
"269",2024-04-14,"SSMH-SA","SSMH","SA","21398622",546,1,273.5,545
"270",2024-04-14,"SSMH-SB","SSMH","SB","21362319",474,1,237.5,473
"271",2024-04-14,"SSMH-SI","SSMH","SI","21398619",433,1,217,432
"272",2024-04-14,"TNHA-BASE","TNHA","BASE","21176526",518,1,259.5,517
"273",2024-04-14,"TNHA-SA","TNHA","SA","21398620",726,1,363.5,725
"274",2024-04-14,"TNHA-SB","TNHA","SB","21362318",413,1,207,412
"275",2024-04-14,"TNHA-SC","TNHA","SC","21362317",193,1,97,192
"276",2024-04-14,"TNHA-SD","TNHA","SD","21362315",613,1,307,612
"277",2024-04-15,"SSMH-SA","SSMH","SA","21398622",448,1,224.5,447
"278",2024-04-15,"SSMH-SB","SSMH","SB","21362319",374,1,187.5,373
"279",2024-04-15,"SSMH-SI","SSMH","SI","21398619",289,1,145,288
"280",2024-04-15,"TNHA-BASE","TNHA","BASE","21176526",407,1,204,406
"281",2024-04-15,"TNHA-SA","TNHA","SA","21398620",574,1,287.5,573
"282",2024-04-15,"TNHA-SB","TNHA","SB","21362318",391,1,196,390
"283",2024-04-15,"TNHA-SC","TNHA","SC","21362317",154,1,77.5,153
"284",2024-04-15,"TNHA-SD","TNHA","SD","21362315",187,1,94,186
"285",2024-04-16,"SSMH-SA","SSMH","SA","21398622",402,1,201.5,401
"286",2024-04-16,"SSMH-SB","SSMH","SB","21362319",354,1,177.5,353
"287",2024-04-16,"SSMH-SI","SSMH","SI","21398619",302,1,151.5,301
"288",2024-04-16,"TNHA-BASE","TNHA","BASE","21176526",442,1,221.5,441
"289",2024-04-16,"TNHA-SA","TNHA","SA","21398620",501,1,251,500
"290",2024-04-16,"TNHA-SB","TNHA","SB","21362318",347,1,174,346
"291",2024-04-16,"TNHA-SC","TNHA","SC","21362317",206,1,103.5,205
"292",2024-04-16,"TNHA-SD","TNHA","SD","21362315",362,1,181.5,361
"293",2024-04-17,"SSMH-SA","SSMH","SA","21398622",486,1,243.5,485
"294",2024-04-17,"SSMH-SB","SSMH","SB","21362319",366,1,183.5,365
"295",2024-04-17,"SSMH-SI","SSMH","SI","21398619",314,1,157.5,313
"296",2024-04-17,"TNHA-BASE","TNHA","BASE","21176526",546,1,273.5,545
"297",2024-04-17,"TNHA-SA","TNHA","SA","21398620",564,1,282.5,563
"298",2024-04-17,"TNHA-SB","TNHA","SB","21362318",391,1,196,390
"299",2024-04-17,"TNHA-SC","TNHA","SC","21362317",164,1,82.5,163
"300",2024-04-17,"TNHA-SD","TNHA","SD","21362315",459,1,230,458
"301",2024-04-18,"SSMH-SA","SSMH","SA","21398622",414,1,207.5,413
"302",2024-04-18,"SSMH-SB","SSMH","SB","21362319",312,1,156.5,311
"303",2024-04-18,"SSMH-SI","SSMH","SI","21398619",243,1,122,242
"304",2024-04-18,"TNHA-BASE","TNHA","BASE","21176526",389,1,195,388
"305",2024-04-18,"TNHA-SA","TNHA","SA","21398620",468,1,234.5,467
"306",2024-04-18,"TNHA-SB","TNHA","SB","21362318",353,1,177,352
"307",2024-04-18,"TNHA-SC","TNHA","SC","21362317",193,1,97,192
"308",2024-04-18,"TNHA-SD","TNHA","SD","21362315",163,1,82,162
"309",2024-04-19,"SSMH-SA","SSMH","SA","21398622",306,1,153.5,305
"310",2024-04-19,"SSMH-SB","SSMH","SB","21362319",162,1,81.5,161
"311",2024-04-19,"SSMH-SI","SSMH","SI","21398619",241,1,121,240
"312",2024-04-19,"TNHA-BASE","TNHA","BASE","21176526",332,1,166.5,331
"313",2024-04-19,"TNHA-SA","TNHA","SA","21398620",263,1,132,262
"314",2024-04-19,"TNHA-SB","TNHA","SB","21362318",298,1,149.5,297
"315",2024-04-19,"TNHA-SC","TNHA","SC","21362317",184,1,92.5,183
"316",2024-04-19,"TNHA-SD","TNHA","SD","21362315",249,1,125,248
"317",2024-04-20,"SSMH-SA","SSMH","SA","21398622",359,1,180,358
"318",2024-04-20,"SSMH-SB","SSMH","SB","21362319",279,1,140,278
"319",2024-04-20,"SSMH-SI","SSMH","SI","21398619",268,1,134.5,267
"320",2024-04-20,"TNHA-BASE","TNHA","BASE","21176526",369,1,185,368
"321",2024-04-20,"TNHA-SA","TNHA","SA","21398620",377,1,189,376
"322",2024-04-20,"TNHA-SB","TNHA","SB","21362318",343,1,172,342
"323",2024-04-20,"TNHA-SC","TNHA","SC","21362317",216,1,108.5,215
"324",2024-04-20,"TNHA-SD","TNHA","SD","21362315",202,1,101.5,201
"325",2024-04-21,"SSMH-SA","SSMH","SA","21398622",601,1,301,600
"326",2024-04-21,"SSMH-SB","SSMH","SB","21362319",491,1,246,490
"327",2024-04-21,"SSMH-SI","SSMH","SI","21398619",468,1,234.5,467
"328",2024-04-21,"TNHA-BASE","TNHA","BASE","21176526",581,1,291,580
"329",2024-04-21,"TNHA-SA","TNHA","SA","21398620",768,1,384.5,767
"330",2024-04-21,"TNHA-SB","TNHA","SB","21362318",452,1,226.5,451
"331",2024-04-21,"TNHA-SC","TNHA","SC","21362317",262,1,131.5,261
"332",2024-04-21,"TNHA-SD","TNHA","SD","21362315",651,1,326,650
"333",2024-04-22,"SSMH-SA","SSMH","SA","21398622",563,1,282,562
"334",2024-04-22,"SSMH-SB","SSMH","SB","21362319",487,1,244,486
"335",2024-04-22,"SSMH-SI","SSMH","SI","21398619",356,1,178.5,355
"336",2024-04-22,"TNHA-BASE","TNHA","BASE","21176526",533,1,267,532
"337",2024-04-22,"TNHA-SA","TNHA","SA","21398620",767,1,384,766
"338",2024-04-22,"TNHA-SB","TNHA","SB","21362318",443,1,222,442
"339",2024-04-22,"TNHA-SC","TNHA","SC","21362317",213,1,107,212
"340",2024-04-22,"TNHA-SD","TNHA","SD","21362315",122,1,61.5,121
"341",2024-04-23,"SSMH-SA","SSMH","SA","21398622",462,1,231.5,461
"342",2024-04-23,"SSMH-SB","SSMH","SB","21362319",332,1,166.5,331
"343",2024-04-23,"SSMH-SI","SSMH","SI","21398619",396,1,198.5,395
"344",2024-04-23,"TNHA-BASE","TNHA","BASE","21176526",488,1,244.5,487
"345",2024-04-23,"TNHA-SA","TNHA","SA","21398620",481,1,241,480
"346",2024-04-23,"TNHA-SB","TNHA","SB","21362318",403,1,202,402
"347",2024-04-23,"TNHA-SC","TNHA","SC","21362317",187,1,94,186
"348",2024-04-23,"TNHA-SD","TNHA","SD","21362315",456,1,228.5,455
"349",2024-04-24,"SSMH-SA","SSMH","SA","21398622",408,1,204.5,407
"350",2024-04-24,"SSMH-SB","SSMH","SB","21362319",242,1,121.5,241
"351",2024-04-24,"SSMH-SI","SSMH","SI","21398619",291,1,146,290
"352",2024-04-24,"TNHA-BASE","TNHA","BASE","21176526",349,1,175,348
"353",2024-04-24,"TNHA-SA","TNHA","SA","21398620",366,1,183.5,365
"354",2024-04-24,"TNHA-SB","TNHA","SB","21362318",389,1,195,388
"355",2024-04-24,"TNHA-SC","TNHA","SC","21362317",199,1,100,198
"356",2024-04-24,"TNHA-SD","TNHA","SD","21362315",218,1,109.5,217
"357",2024-04-25,"SSMH-SA","SSMH","SA","21398622",607,1,304,606
"358",2024-04-25,"SSMH-SB","SSMH","SB","21362319",513,1,257,512
"359",2024-04-25,"SSMH-SI","SSMH","SI","21398619",464,1,232.5,463
"360",2024-04-25,"TNHA-BASE","TNHA","BASE","21176526",569,1,285,568
"361",2024-04-25,"TNHA-SA","TNHA","SA","21398620",764,1,382.5,763
"362",2024-04-25,"TNHA-SB","TNHA","SB","21362318",459,1,230,458
"363",2024-04-25,"TNHA-SD","TNHA","SD","21362315",626,1,313.5,625
"364",2024-04-26,"SSMH-SA","SSMH","SA","21398622",581,1,291,580
"365",2024-04-26,"SSMH-SB","SSMH","SB","21362319",508,1,254.5,507
"366",2024-04-26,"SSMH-SI","SSMH","SI","21398619",369,1,185,368
"367",2024-04-26,"TNHA-BASE","TNHA","BASE","21176526",521,1,261,520
"368",2024-04-26,"TNHA-SA","TNHA","SA","21398620",767,1,384,766
"369",2024-04-26,"TNHA-SB","TNHA","SB","21362318",444,1,222.5,443
"370",2024-04-26,"TNHA-SD","TNHA","SD","21362315",267,1,134,266
"371",2024-04-27,"SSMH-SA","SSMH","SA","21398622",639,1,320,638
"372",2024-04-27,"SSMH-SB","SSMH","SB","21362319",539,1,270,538
"373",2024-04-27,"SSMH-SI","SSMH","SI","21398619",504,1,252.5,503
"374",2024-04-27,"TNHA-BASE","TNHA","BASE","21176526",643,1,322,642
"375",2024-04-27,"TNHA-SA","TNHA","SA","21398620",807,1,404,806
"376",2024-04-27,"TNHA-SB","TNHA","SB","21362318",483,1,242,482
"377",2024-04-27,"TNHA-SD","TNHA","SD","21362315",687,1,344,686
"378",2024-04-28,"SSMH-SA","SSMH","SA","21398622",612,1,306.5,611
"379",2024-04-28,"SSMH-SB","SSMH","SB","21362319",534,1,267.5,533
"380",2024-04-28,"SSMH-SI","SSMH","SI","21398619",507,1,254,506
"381",2024-04-28,"TNHA-BASE","TNHA","BASE","21176526",691,1,346,690
"382",2024-04-28,"TNHA-SA","TNHA","SA","21398620",812,1,406.5,811
"383",2024-04-28,"TNHA-SB","TNHA","SB","21362318",479,1,240,478
"384",2024-04-28,"TNHA-SD","TNHA","SD","21362315",682,1,341.5,681
"385",2024-04-29,"SSMH-SA","SSMH","SA","21398622",646,1,323.5,645
"386",2024-04-29,"SSMH-SB","SSMH","SB","21362319",549,1,275,548
"387",2024-04-29,"SSMH-SI","SSMH","SI","21398619",514,1,257.5,513
"388",2024-04-29,"TNHA-BASE","TNHA","BASE","21176526",669,1,335,668
"389",2024-04-29,"TNHA-SA","TNHA","SA","21398620",807,1,404,806
"390",2024-04-29,"TNHA-SB","TNHA","SB","21362318",496,1,248.5,495
"391",2024-04-29,"TNHA-SD","TNHA","SD","21362315",691,1,346,690
"392",2024-04-30,"SSMH-SA","SSMH","SA","21398622",642,1,321.5,641
"393",2024-04-30,"SSMH-SB","SSMH","SB","21362319",529,1,265,528
"394",2024-04-30,"SSMH-SI","SSMH","SI","21398619",459,1,230,458
"395",2024-04-30,"TNHA-BASE","TNHA","BASE","21176526",632,1,316.5,631
"396",2024-04-30,"TNHA-SA","TNHA","SA","21398620",802,1,401.5,801
"397",2024-04-30,"TNHA-SB","TNHA","SB","21362318",483,1,242,482
"398",2024-04-30,"TNHA-SD","TNHA","SD","21362315",622,1,311.5,621
"399",2024-05-01,"SSMH-SA","SSMH","SA","21398622",619,1,310,618
"400",2024-05-01,"SSMH-SB","SSMH","SB","21362319",541,1,271,540
"401",2024-05-01,"SSMH-SI","SSMH","SI","21398619",429,1,215,428
"402",2024-05-01,"TNHA-BASE","TNHA","BASE","21176526",732,1,366.5,731
"403",2024-05-01,"TNHA-SA","TNHA","SA","21398620",813,1,407,812
"404",2024-05-01,"TNHA-SB","TNHA","SB","21362318",511,1,256,510
"405",2024-05-01,"TNHA-SD","TNHA","SD","21362315",478,1,239.5,477
"406",2024-05-02,"SSMH-SA","SSMH","SA","21398622",647,1,324,646
"407",2024-05-02,"SSMH-SB","SSMH","SB","21362319",542,1,271.5,541
"408",2024-05-02,"SSMH-SI","SSMH","SI","21398619",428,1,214.5,427
"409",2024-05-02,"TNHA-BASE","TNHA","BASE","21176526",557,1,279,556
"410",2024-05-02,"TNHA-SA","TNHA","SA","21398620",787,1,394,786
"411",2024-05-02,"TNHA-SB","TNHA","SB","21362318",493,1,247,492
"412",2024-05-02,"TNHA-SD","TNHA","SD","21362315",557,1,279,556
"413",2024-05-03,"SSMH-SA","SSMH","SA","21398622",584,1,292.5,583
"414",2024-05-03,"SSMH-SB","SSMH","SB","21362319",524,1,262.5,523
"415",2024-05-03,"SSMH-SI","SSMH","SI","21398619",376,1,188.5,375
"416",2024-05-03,"TNHA-BASE","TNHA","BASE","21176526",597,1,299,596
"417",2024-05-03,"TNHA-SA","TNHA","SA","21398620",799,1,400,798
"418",2024-05-03,"TNHA-SB","TNHA","SB","21362318",486,1,243.5,485
"419",2024-05-03,"TNHA-SD","TNHA","SD","21362315",308,1,154.5,307
"420",2024-05-04,"SSMH-SA","SSMH","SA","21398622",607,1,304,606
"421",2024-05-04,"SSMH-SB","SSMH","SB","21362319",471,1,236,470
"422",2024-05-04,"SSMH-SI","SSMH","SI","21398619",522,1,261.5,521
"423",2024-05-04,"TNHA-BASE","TNHA","BASE","21176526",657,1,329,656
"424",2024-05-04,"TNHA-SA","TNHA","SA","21398620",721,1,361,720
"425",2024-05-04,"TNHA-SB","TNHA","SB","21362318",499,1,250,498
"426",2024-05-04,"TNHA-SD","TNHA","SD","21362315",701,1,351,700
"427",2024-05-05,"SSMH-SA","SSMH","SA","21398622",617,1,309,616
"428",2024-05-05,"SSMH-SB","SSMH","SB","21362319",532,1,266.5,531
"429",2024-05-05,"SSMH-SI","SSMH","SI","21398619",526,1,263.5,525
"430",2024-05-05,"TNHA-BASE","TNHA","BASE","21176526",726,1,363.5,725
"431",2024-05-05,"TNHA-SA","TNHA","SA","21398620",822,1,411.5,821
"432",2024-05-05,"TNHA-SB","TNHA","SB","21362318",501,1,251,500
"433",2024-05-05,"TNHA-SC","TNHA","SC","21362317",27,27,27,0
"434",2024-05-05,"TNHA-SD","TNHA","SD","21362315",641,1,321,640
"435",2024-05-06,"SSMH-SA","SSMH","SA","21398622",352,1,176.5,351
"436",2024-05-06,"SSMH-SB","SSMH","SB","21362319",253,1,127,252
"437",2024-05-06,"SSMH-SI","SSMH","SI","21398619",318,1,159.5,317
"438",2024-05-06,"TNHA-BASE","TNHA","BASE","21176526",357,1,179,356
"439",2024-05-06,"TNHA-SA","TNHA","SA","21398620",246,1,123.5,245
"440",2024-05-06,"TNHA-SB","TNHA","SB","21362318",362,1,181.5,361
"441",2024-05-06,"TNHA-SD","TNHA","SD","21362315",234,1,117.5,233
"442",2024-05-07,"SSMH-SA","SSMH","SA","21398622",299,1,150,298
"443",2024-05-07,"SSMH-SB","SSMH","SB","21362319",217,1,109,216
"444",2024-05-07,"SSMH-SI","SSMH","SI","21398619",301,1,151,300
"445",2024-05-07,"TNHA-BASE","TNHA","BASE","21176526",371,1,186,370
"446",2024-05-07,"TNHA-SA","TNHA","SA","21398620",204,1,102.5,203
"447",2024-05-07,"TNHA-SB","TNHA","SB","21362318",334,1,167.5,333
"448",2024-05-07,"TNHA-SD","TNHA","SD","21362315",217,1,109,216
"449",2024-05-08,"SSMH-SA","SSMH","SA","21398622",381,1,191,380
"450",2024-05-08,"SSMH-SB","SSMH","SB","21362319",276,1,138.5,275
"451",2024-05-08,"SSMH-SI","SSMH","SI","21398619",346,2,174,344
"452",2024-05-08,"TNHA-BASE","TNHA","BASE","21176526",362,1,181.5,361
"453",2024-05-08,"TNHA-SA","TNHA","SA","21398620",244,1,122.5,243
"454",2024-05-08,"TNHA-SB","TNHA","SB","21362318",384,2,193,382
"455",2024-05-08,"TNHA-SD","TNHA","SD","21362315",249,1,125,248
"456",2024-05-09,"SSMH-SA","SSMH","SA","21398622",669,1,335,668
"457",2024-05-09,"SSMH-SB","SSMH","SB","21362319",551,1,276,550
"458",2024-05-09,"SSMH-SI","SSMH","SI","21398619",533,1,267,532
"459",2024-05-09,"TNHA-BASE","TNHA","BASE","21176526",636,1,318.5,635
"460",2024-05-09,"TNHA-SA","TNHA","SA","21398620",774,1,387.5,773
"461",2024-05-09,"TNHA-SB","TNHA","SB","21362318",527,1,264,526
"462",2024-05-09,"TNHA-SD","TNHA","SD","21362315",734,1,367.5,733
"463",2024-05-10,"SSMH-SA","SSMH","SA","21398622",658,2,330,656
"464",2024-05-10,"SSMH-SB","SSMH","SB","21362319",498,1,249.5,497
"465",2024-05-10,"SSMH-SI","SSMH","SI","21398619",546,2,274,544
"466",2024-05-10,"TNHA-BASE","TNHA","BASE","21176526",617,2,309.5,615
"467",2024-05-10,"TNHA-SA","TNHA","SA","21398620",723,1,362,722
"468",2024-05-10,"TNHA-SB","TNHA","SB","21362318",513,3,258,510
"469",2024-05-10,"TNHA-SD","TNHA","SD","21362315",726,1,363.5,725
"470",2024-05-11,"SSMH-SA","SSMH","SA","21398622",687,3,345,684
"471",2024-05-11,"SSMH-SB","SSMH","SB","21362319",563,2,282.5,561
"472",2024-05-11,"SSMH-SI","SSMH","SI","21398619",381,3,192,378
"473",2024-05-11,"TNHA-BASE","TNHA","BASE","21176526",654,3,328.5,651
"474",2024-05-11,"TNHA-SA","TNHA","SA","21398620",812,1,406.5,811
"475",2024-05-11,"TNHA-SB","TNHA","SB","21362318",546,4,275,542
"476",2024-05-11,"TNHA-SD","TNHA","SD","21362315",522,2,262,520
"477",2024-05-12,"SSMH-SA","SSMH","SA","21398622",598,2,300,596
"478",2024-05-12,"SSMH-SB","SSMH","SB","21362319",523,1,262,522
"479",2024-05-12,"SSMH-SI","SSMH","SI","21398619",427,2,214.5,425
"480",2024-05-12,"TNHA-BASE","TNHA","BASE","21176526",693,2,347.5,691
"481",2024-05-12,"TNHA-SA","TNHA","SA","21398620",719,1,360,718
"482",2024-05-12,"TNHA-SB","TNHA","SB","21362318",526,2,264,524
"483",2024-05-12,"TNHA-SD","TNHA","SD","21362315",289,1,145,288
"484",2024-05-13,"SSMH-SA","SSMH","SA","21398622",434,4,219,430
"485",2024-05-13,"SSMH-SB","SSMH","SB","21362319",329,2,165.5,327
"486",2024-05-13,"SSMH-SI","SSMH","SI","21398619",349,3,176,346
"487",2024-05-13,"TNHA-BASE","TNHA","BASE","21176526",431,4,217.5,427
"488",2024-05-13,"TNHA-SA","TNHA","SA","21398620",431,2,216.5,429
"489",2024-05-13,"TNHA-SB","TNHA","SB","21362318",458,4,231,454
"490",2024-05-13,"TNHA-SD","TNHA","SD","21362315",279,2,140.5,277
"491",2024-05-14,"SSMH-SA","SSMH","SA","21398622",501,3,252,498
"492",2024-05-14,"SSMH-SB","SSMH","SB","21362319",343,2,172.5,341
"493",2024-05-14,"SSMH-SI","SSMH","SI","21398619",368,3,185.5,365
"494",2024-05-14,"TNHA-BASE","TNHA","BASE","21176526",411,3,207,408
"495",2024-05-14,"TNHA-SA","TNHA","SA","21398620",304,1,152.5,303
"496",2024-05-14,"TNHA-SB","TNHA","SB","21362318",423,3,213,420
"497",2024-05-14,"TNHA-SD","TNHA","SD","21362315",333,2,167.5,331
"498",2024-05-15,"SSMH-SA","SSMH","SA","21398622",612,4,308,608
"499",2024-05-15,"SSMH-SB","SSMH","SB","21362319",452,2,227,450
"500",2024-05-15,"SSMH-SI","SSMH","SI","21398619",552,6,279,546
"501",2024-05-15,"TNHA-BASE","TNHA","BASE","21176526",667,4,335.5,663
"502",2024-05-15,"TNHA-SA","TNHA","SA","21398620",643,2,322.5,641
"503",2024-05-15,"TNHA-SB","TNHA","SB","21362318",528,6,267,522
"504",2024-05-15,"TNHA-SD","TNHA","SD","21362315",728,2,365,726
"505",2024-05-16,"SSMH-SA","SSMH","SA","21398622",688,9,348.5,679
"506",2024-05-16,"SSMH-SB","SSMH","SB","21362319",561,7,284,554
"507",2024-05-16,"SSMH-SI","SSMH","SI","21398619",572,14,293,558
"508",2024-05-16,"TNHA-BASE","TNHA","BASE","21176526",647,13,330,634
"509",2024-05-16,"TNHA-SA","TNHA","SA","21398620",776,4,390,772
"510",2024-05-16,"TNHA-SB","TNHA","SB","21362318",551,23,287,528
"511",2024-05-16,"TNHA-SD","TNHA","SD","21362315",746,9,377.5,737
"512",2024-05-17,"SSMH-SA","SSMH","SA","21398622",698,4,351,694
"513",2024-05-17,"SSMH-SB","SSMH","SB","21362319",571,3,287,568
"514",2024-05-17,"SSMH-SI","SSMH","SI","21398619",574,6,290,568
"515",2024-05-17,"TNHA-BASE","TNHA","BASE","21176526",748,4,376,744
"516",2024-05-17,"TNHA-SA","TNHA","SA","21398620",763,2,382.5,761
"517",2024-05-17,"TNHA-SB","TNHA","SB","21362318",554,8,281,546
"518",2024-05-17,"TNHA-SD","TNHA","SD","21362315",714,2,358,712
"519",2024-05-18,"SSMH-SA","SSMH","SA","21398622",666,6,336,660
"520",2024-05-18,"SSMH-SB","SSMH","SB","21362319",551,7,279,544
"521",2024-05-18,"SSMH-SI","SSMH","SI","21398619",494,17,255.5,477
"522",2024-05-18,"TNHA-BASE","TNHA","BASE","21176526",614,6,310,608
"523",2024-05-18,"TNHA-SA","TNHA","SA","21398620",762,4,383,758
"524",2024-05-18,"TNHA-SB","TNHA","SB","21362318",538,18,278,520
"525",2024-05-18,"TNHA-SD","TNHA","SD","21362315",201,8,104.5,193
"526",2024-05-19,"SSMH-SA","SSMH","SA","21398622",367,6,186.5,361
"527",2024-05-19,"SSMH-SB","SSMH","SB","21362319",247,2,124.5,245
"528",2024-05-19,"SSMH-SI","SSMH","SI","21398619",314,4,159,310
"529",2024-05-19,"TNHA-BASE","TNHA","BASE","21176526",444,6,225,438
"530",2024-05-19,"TNHA-SA","TNHA","SA","21398620",219,2,110.5,217
"531",2024-05-19,"TNHA-SB","TNHA","SB","21362318",348,4,176,344
"532",2024-05-19,"TNHA-SD","TNHA","SD","21362315",223,2,112.5,221
"533",2024-05-20,"SSMH-SA","SSMH","SA","21398622",341,4,172.5,337
"534",2024-05-20,"SSMH-SB","SSMH","SB","21362319",233,2,117.5,231
"535",2024-05-20,"SSMH-SI","SSMH","SI","21398619",309,4,156.5,305
"536",2024-05-20,"TNHA-BASE","TNHA","BASE","21176526",402,4,203,398
"537",2024-05-20,"TNHA-SA","TNHA","SA","21398620",204,2,103,202
"538",2024-05-20,"TNHA-SB","TNHA","SB","21362318",336,4,170,332
"539",2024-05-20,"TNHA-SD","TNHA","SD","21362315",217,2,109.5,215
"540",2024-05-21,"SSMH-SA","SSMH","SA","21398622",451,7,229,444
"541",2024-05-21,"SSMH-SB","SSMH","SB","21362319",299,4,151.5,295
"542",2024-05-21,"SSMH-SI","SSMH","SI","21398619",346,6,176,340
"543",2024-05-21,"TNHA-BASE","TNHA","BASE","21176526",416,6,211,410
"544",2024-05-21,"TNHA-SA","TNHA","SA","21398620",334,2,168,332
"545",2024-05-21,"TNHA-SB","TNHA","SB","21362318",429,7,218,422
"546",2024-05-21,"TNHA-SD","TNHA","SD","21362315",292,3,147.5,289
"547",2024-05-22,"SSMH-SA","SSMH","SA","21398622",501,8,254.5,493
"548",2024-05-22,"SSMH-SB","SSMH","SB","21362319",383,6,194.5,377
"549",2024-05-22,"SSMH-SI","SSMH","SI","21398619",466,13,239.5,453
"550",2024-05-22,"TNHA-BASE","TNHA","BASE","21176526",581,8,294.5,573
"551",2024-05-22,"TNHA-SA","TNHA","SA","21398620",508,4,256,504
"552",2024-05-22,"TNHA-SB","TNHA","SB","21362318",456,14,235,442
"553",2024-05-22,"TNHA-SD","TNHA","SD","21362315",546,6,276,540
"554",2024-05-23,"SSMH-SA","SSMH","SA","21398622",476,9,242.5,467
"555",2024-05-23,"SSMH-SB","SSMH","SB","21362319",206,6,106,200
"556",2024-05-23,"SSMH-SI","SSMH","SI","21398619",457,9,233,448
"557",2024-05-23,"TNHA-BASE","TNHA","BASE","21176526",518,11,264.5,507
"558",2024-05-23,"TNHA-SA","TNHA","SA","21398620",283,4,143.5,279
"559",2024-05-23,"TNHA-SB","TNHA","SB","21362318",421,9,215,412
"560",2024-05-23,"TNHA-SD","TNHA","SD","21362315",484,6,245,478
"561",2024-05-24,"SSMH-SA","SSMH","SA","21398622",332,8,170,324
"562",2024-05-24,"SSMH-SB","SSMH","SB","21362319",227,4,115.5,223
"563",2024-05-24,"SSMH-SI","SSMH","SI","21398619",304,7,155.5,297
"564",2024-05-24,"TNHA-BASE","TNHA","BASE","21176526",314,7,160.5,307
"565",2024-05-24,"TNHA-SA","TNHA","SA","21398620",184,3,93.5,181
"566",2024-05-24,"TNHA-SB","TNHA","SB","21362318",332,7,169.5,325
"567",2024-05-24,"TNHA-SD","TNHA","SD","21362315",216,4,110,212
"568",2024-05-25,"SSMH-SA","SSMH","SA","21398622",653,3,328,650
"569",2024-05-25,"SSMH-SB","SSMH","SB","21362319",437,2,219.5,435
"570",2024-05-25,"SSMH-SI","SSMH","SI","21398619",434,3,218.5,431
"571",2024-05-25,"TNHA-BASE","TNHA","BASE","21176526",742,3,372.5,739
"572",2024-05-25,"TNHA-SA","TNHA","SA","21398620",637,1,319,636
"573",2024-05-25,"TNHA-SB","TNHA","SB","21362318",563,2,282.5,561
"574",2024-05-25,"TNHA-SD","TNHA","SD","21362315",549,1,275,548
"575",2024-05-26,"SSMH-SA","SSMH","SA","21398622",589,8,298.5,581
"576",2024-05-26,"SSMH-SB","SSMH","SB","21362319",422,7,214.5,415
"577",2024-05-26,"SSMH-SI","SSMH","SI","21398619",362,11,186.5,351
"578",2024-05-26,"TNHA-BASE","TNHA","BASE","21176526",618,8,313,610
"579",2024-05-26,"TNHA-SA","TNHA","SA","21398620",614,2,308,612
"580",2024-05-26,"TNHA-SB","TNHA","SB","21362318",523,9,266,514
"581",2024-05-26,"TNHA-SD","TNHA","SD","21362315",348,6,177,342
"582",2024-05-27,"SSMH-SA","SSMH","SA","21398622",367,8,187.5,359
"583",2024-05-27,"SSMH-SB","SSMH","SB","21362319",238,4,121,234
"584",2024-05-27,"SSMH-SI","SSMH","SI","21398619",331,8,169.5,323
"585",2024-05-27,"TNHA-BASE","TNHA","BASE","21176526",363,7,185,356
"586",2024-05-27,"TNHA-SA","TNHA","SA","21398620",213,3,108,210
"587",2024-05-27,"TNHA-SB","TNHA","SB","21362318",367,9,188,358
"588",2024-05-27,"TNHA-SD","TNHA","SD","21362315",253,4,128.5,249
"589",2024-05-28,"SSMH-SA","SSMH","SA","21398622",421,12,216.5,409
"590",2024-05-28,"SSMH-SB","SSMH","SB","21362319",249,7,128,242
"591",2024-05-28,"SSMH-SI","SSMH","SI","21398619",358,11,184.5,347
"592",2024-05-28,"TNHA-BASE","TNHA","BASE","21176526",439,12,225.5,427
"593",2024-05-28,"TNHA-SA","TNHA","SA","21398620",263,6,134.5,257
"594",2024-05-28,"TNHA-SB","TNHA","SB","21362318",401,13,207,388
"595",2024-05-28,"TNHA-SD","TNHA","SD","21362315",314,7,160.5,307
"596",2024-05-29,"SSMH-SA","SSMH","SA","21398622",722,11,366.5,711
"597",2024-05-29,"SSMH-SB","SSMH","SB","21362319",583,12,297.5,571
"598",2024-05-29,"SSMH-SI","SSMH","SI","21398619",607,36,321.5,571
"599",2024-05-29,"TNHA-BASE","TNHA","BASE","21176526",683,11,347,672
"600",2024-05-29,"TNHA-SA","TNHA","SA","21398620",733,8,370.5,725
"601",2024-05-29,"TNHA-SB","TNHA","SB","21362318",582,28,305,554
"602",2024-05-29,"TNHA-SD","TNHA","SD","21362315",778,14,396,764
"603",2024-05-30,"SSMH-SA","SSMH","SA","21398622",734,9,371.5,725
"604",2024-05-30,"SSMH-SB","SSMH","SB","21362319",602,9,305.5,593
"605",2024-05-30,"SSMH-SI","SSMH","SI","21398619",616,42,329,574
"606",2024-05-30,"TNHA-BASE","TNHA","BASE","21176526",694,11,352.5,683
"607",2024-05-30,"TNHA-SA","TNHA","SA","21398620",768,7,387.5,761
"608",2024-05-30,"TNHA-SB","TNHA","SB","21362318",602,33,317.5,569
"609",2024-05-30,"TNHA-SD","TNHA","SD","21362315",788,14,401,774
"610",2024-05-31,"SSMH-SA","SSMH","SA","21398622",719,719,719,0
"611",2024-05-31,"SSMH-SB","SSMH","SB","21362319",589,589,589,0
"612",2024-05-31,"SSMH-SI","SSMH","SI","21398619",48,48,48,0
"613",2024-05-31,"TNHA-BASE","TNHA","BASE","21176526",653,653,653,0
"614",2024-05-31,"TNHA-SA","TNHA","SA","21398620",809,809,809,0
"615",2024-05-31,"TNHA-SB","TNHA","SB","21362318",574,574,574,0
"616",2024-05-31,"TNHA-SD","TNHA","SD","21362315",46,46,46,0
