"","Date","fullname","site","station","sensor","max","min","avg","amp"
"1",2023-06-01,"BEO-BASE","BEO","BASE","21350855",351,288,319.5,63
"2",2023-06-01,"SSMH-SA","SSMH","SA","21206911",95,60,77.5,35
"3",2023-06-01,"SSMH-SB","SSMH","SB","21206912",358,1,179.5,357
"4",2023-06-01,"TNHA-BASE","TNHA","BASE","21167037",341,0,170.5,341
"5",2023-06-01,"TNHA-SA","TNHA","SA","21398709",323,35,179,288
"6",2023-06-01,"TNHA-SB","TNHA","SB","21181033",175,157,166,18
"7",2023-06-01,"TNHA-SC","TNHA","SC","21206909",330,42,186,288
"8",2023-06-01,"TNHA-SD","TNHA","SD","21398712",352,1,176.5,351
"9",2023-06-02,"BEO-BASE","BEO","BASE","21350855",293,110,201.5,183
"10",2023-06-02,"SSMH-SA","SSMH","SA","21206911",354,299,326.5,55
"11",2023-06-02,"SSMH-SB","SSMH","SB","21206912",358,11,184.5,347
"12",2023-06-02,"TNHA-BASE","TNHA","BASE","21167037",326,25,175.5,301
"13",2023-06-02,"TNHA-SA","TNHA","SA","21398709",129,104,116.5,25
"14",2023-06-02,"TNHA-SB","TNHA","SB","21181033",159,154,156.5,5
"15",2023-06-02,"TNHA-SC","TNHA","SC","21206909",286,70,178,216
"16",2023-06-02,"TNHA-SD","TNHA","SD","21398712",354,32,193,322
"17",2023-06-03,"BEO-BASE","BEO","BASE","21350855",313,159,236,154
"18",2023-06-03,"SSMH-SA","SSMH","SA","21206911",309,7,158,302
"19",2023-06-03,"SSMH-SB","SSMH","SB","21206912",358,6,182,352
"20",2023-06-03,"TNHA-BASE","TNHA","BASE","21167037",348,41,194.5,307
"21",2023-06-03,"TNHA-SA","TNHA","SA","21398709",320,107,213.5,213
"22",2023-06-03,"TNHA-SB","TNHA","SB","21181033",163,153,158,10
"23",2023-06-03,"TNHA-SC","TNHA","SC","21206909",338,58,198,280
"24",2023-06-03,"TNHA-SD","TNHA","SD","21398712",358,8,183,350
"25",2023-06-04,"BEO-BASE","BEO","BASE","21350855",330,173,251.5,157
"26",2023-06-04,"SSMH-SA","SSMH","SA","21206911",351,20,185.5,331
"27",2023-06-04,"SSMH-SB","SSMH","SB","21206912",358,1,179.5,357
"28",2023-06-04,"TNHA-BASE","TNHA","BASE","21167037",358,44,201,314
"29",2023-06-04,"TNHA-SA","TNHA","SA","21398709",317,112,214.5,205
"30",2023-06-04,"TNHA-SB","TNHA","SB","21181033",171,150,160.5,21
"31",2023-06-04,"TNHA-SC","TNHA","SC","21206909",357,17,187,340
"32",2023-06-04,"TNHA-SD","TNHA","SD","21398712",350,6,178,344
"33",2023-06-05,"BEO-BASE","BEO","BASE","21350855",331,17,174,314
"34",2023-06-05,"SSMH-SA","SSMH","SA","21206911",108,79,93.5,29
"35",2023-06-05,"SSMH-SB","SSMH","SB","21206912",358,1,179.5,357
"36",2023-06-05,"TNHA-BASE","TNHA","BASE","21167037",340,20,180,320
"37",2023-06-05,"TNHA-SA","TNHA","SA","21398709",316,107,211.5,209
"38",2023-06-05,"TNHA-SB","TNHA","SB","21181033",160,142,151,18
"39",2023-06-05,"TNHA-SC","TNHA","SC","21206909",306,4,155,302
"40",2023-06-05,"TNHA-SD","TNHA","SD","21398712",355,15,185,340
"41",2023-06-06,"BEO-BASE","BEO","BASE","21350855",327,88,207.5,239
"42",2023-06-06,"SSMH-SA","SSMH","SA","21206911",329,321,325,8
"43",2023-06-06,"SSMH-SB","SSMH","SB","21206912",358,1,179.5,357
"44",2023-06-06,"TNHA-BASE","TNHA","BASE","21167037",298,48,173,250
"45",2023-06-06,"TNHA-SA","TNHA","SA","21398709",340,69,204.5,271
"46",2023-06-06,"TNHA-SB","TNHA","SB","21181033",154,152,153,2
"47",2023-06-06,"TNHA-SC","TNHA","SC","21206909",357,84,220.5,273
"48",2023-06-06,"TNHA-SD","TNHA","SD","21398712",354,90,222,264
"49",2023-06-07,"BEO-BASE","BEO","BASE","21350855",168,135,151.5,33
"50",2023-06-07,"SSMH-SA","SSMH","SA","21206911",321,299,310,22
"51",2023-06-07,"SSMH-SB","SSMH","SB","21206912",270,86,178,184
"52",2023-06-07,"TNHA-BASE","TNHA","BASE","21167037",251,209,230,42
"53",2023-06-07,"TNHA-SA","TNHA","SA","21398709",142,114,128,28
"54",2023-06-07,"TNHA-SB","TNHA","SB","21181033",156,146,151,10
"55",2023-06-07,"TNHA-SC","TNHA","SC","21206909",112,102,107,10
"56",2023-06-07,"TNHA-SD","TNHA","SD","21398712",330,272,301,58
"57",2023-06-08,"BEO-BASE","BEO","BASE","21350855",153,102,127.5,51
"58",2023-06-08,"SSMH-SA","SSMH","SA","21206911",319,291,305,28
"59",2023-06-08,"SSMH-SB","SSMH","SB","21206912",229,102,165.5,127
"60",2023-06-08,"TNHA-BASE","TNHA","BASE","21167037",250,22,136,228
"61",2023-06-08,"TNHA-SA","TNHA","SA","21398709",140,119,129.5,21
"62",2023-06-08,"TNHA-SB","TNHA","SB","21181033",153,145,149,8
"63",2023-06-08,"TNHA-SC","TNHA","SC","21206909",112,105,108.5,7
"64",2023-06-08,"TNHA-SD","TNHA","SD","21398712",313,251,282,62
"65",2023-06-09,"BEO-BASE","BEO","BASE","21350855",131,110,120.5,21
"66",2023-06-09,"SSMH-SA","SSMH","SA","21206911",323,289,306,34
"67",2023-06-09,"SSMH-SB","SSMH","SB","21206912",227,163,195,64
"68",2023-06-09,"TNHA-BASE","TNHA","BASE","21167037",272,22,147,250
"69",2023-06-09,"TNHA-SA","TNHA","SA","21398709",131,122,126.5,9
"70",2023-06-09,"TNHA-SB","TNHA","SB","21181033",154,146,150,8
"71",2023-06-09,"TNHA-SC","TNHA","SC","21206909",112,108,110,4
"72",2023-06-09,"TNHA-SD","TNHA","SD","21398712",267,240,253.5,27
"73",2023-06-10,"BEO-BASE","BEO","BASE","21350855",154,119,136.5,35
"74",2023-06-10,"SSMH-SA","SSMH","SA","21206911",300,296,298,4
"75",2023-06-10,"SSMH-SB","SSMH","SB","21206912",343,53,198,290
"76",2023-06-10,"TNHA-BASE","TNHA","BASE","21167037",213,39,126,174
"77",2023-06-10,"TNHA-SA","TNHA","SA","21398709",132,124,128,8
"78",2023-06-10,"TNHA-SB","TNHA","SB","21181033",170,146,158,24
"79",2023-06-10,"TNHA-SC","TNHA","SC","21206909",114,110,112,4
"80",2023-06-10,"TNHA-SD","TNHA","SD","21398712",302,256,279,46
"81",2023-06-11,"BEO-BASE","BEO","BASE","21350855",175,142,158.5,33
"82",2023-06-11,"SSMH-SA","SSMH","SA","21206911",310,299,304.5,11
"83",2023-06-11,"SSMH-SB","SSMH","SB","21206912",296,31,163.5,265
"84",2023-06-11,"TNHA-BASE","TNHA","BASE","21167037",223,212,217.5,11
"85",2023-06-11,"TNHA-SA","TNHA","SA","21398709",136,118,127,18
"86",2023-06-11,"TNHA-SB","TNHA","SB","21181033",163,147,155,16
"87",2023-06-11,"TNHA-SC","TNHA","SC","21206909",264,98,181,166
"88",2023-06-11,"TNHA-SD","TNHA","SD","21398712",351,288,319.5,63
"89",2023-06-12,"BEO-BASE","BEO","BASE","21350855",173,119,146,54
"90",2023-06-12,"SSMH-SA","SSMH","SA","21206911",305,303,304,2
"91",2023-06-12,"SSMH-SB","SSMH","SB","21206912",209,76,142.5,133
"92",2023-06-12,"TNHA-BASE","TNHA","BASE","21167037",225,211,218,14
"93",2023-06-12,"TNHA-SA","TNHA","SA","21398709",135,102,118.5,33
"94",2023-06-12,"TNHA-SB","TNHA","SB","21181033",150,146,148,4
"95",2023-06-12,"TNHA-SC","TNHA","SC","21206909",285,87,186,198
"96",2023-06-12,"TNHA-SD","TNHA","SD","21398712",351,291,321,60
"97",2023-06-13,"BEO-BASE","BEO","BASE","21350855",344,15,179.5,329
"98",2023-06-13,"SSMH-SA","SSMH","SA","21206911",314,84,199,230
"99",2023-06-13,"SSMH-SB","SSMH","SB","21206912",358,1,179.5,357
"100",2023-06-13,"TNHA-BASE","TNHA","BASE","21167037",352,3,177.5,349
"101",2023-06-13,"TNHA-SA","TNHA","SA","21398709",320,117,218.5,203
"102",2023-06-13,"TNHA-SB","TNHA","SB","21181033",152,145,148.5,7
"103",2023-06-13,"TNHA-SC","TNHA","SC","21206909",317,21,169,296
"104",2023-06-13,"TNHA-SD","TNHA","SD","21398712",331,6,168.5,325
"105",2023-06-14,"BEO-BASE","BEO","BASE","21350855",264,108,186,156
"106",2023-06-14,"SSMH-SA","SSMH","SA","21206911",77,42,59.5,35
"107",2023-06-14,"SSMH-SB","SSMH","SB","21206912",358,3,180.5,355
"108",2023-06-14,"TNHA-BASE","TNHA","BASE","21167037",319,180,249.5,139
"109",2023-06-14,"TNHA-SA","TNHA","SA","21398709",296,115,205.5,181
"110",2023-06-14,"TNHA-SB","TNHA","SB","21181033",156,145,150.5,11
"111",2023-06-14,"TNHA-SC","TNHA","SC","21206909",298,73,185.5,225
"112",2023-06-14,"TNHA-SD","TNHA","SD","21398712",358,7,182.5,351
"113",2023-06-15,"BEO-BASE","BEO","BASE","21350855",298,10,154,288
"114",2023-06-15,"SSMH-SA","SSMH","SA","21206911",355,17,186,338
"115",2023-06-15,"SSMH-SB","SSMH","SB","21206912",230,95,162.5,135
"116",2023-06-15,"TNHA-BASE","TNHA","BASE","21167037",358,0,179,358
"117",2023-06-15,"TNHA-SA","TNHA","SA","21398709",319,18,168.5,301
"118",2023-06-15,"TNHA-SB","TNHA","SB","21181033",157,147,152,10
"119",2023-06-15,"TNHA-SC","TNHA","SC","21206909",313,15,164,298
"120",2023-06-15,"TNHA-SD","TNHA","SD","21398712",286,118,202,168
"121",2023-06-16,"BEO-BASE","BEO","BASE","21350855",202,69,135.5,133
"122",2023-06-16,"SSMH-SA","SSMH","SA","21206911",350,296,323,54
"123",2023-06-16,"SSMH-SB","SSMH","SB","21206912",218,87,152.5,131
"124",2023-06-16,"TNHA-BASE","TNHA","BASE","21167037",352,0,176,352
"125",2023-06-16,"TNHA-SA","TNHA","SA","21398709",118,95,106.5,23
"126",2023-06-16,"TNHA-SB","TNHA","SB","21181033",156,154,155,2
"127",2023-06-16,"TNHA-SC","TNHA","SC","21206909",303,10,156.5,293
"128",2023-06-16,"TNHA-SD","TNHA","SD","21398712",350,44,197,306
"129",2023-06-17,"BEO-BASE","BEO","BASE","21350855",161,126,143.5,35
"130",2023-06-17,"SSMH-SA","SSMH","SA","21206911",317,299,308,18
"131",2023-06-17,"SSMH-SB","SSMH","SB","21206912",223,59,141,164
"132",2023-06-17,"TNHA-BASE","TNHA","BASE","21167037",258,17,137.5,241
"133",2023-06-17,"TNHA-SA","TNHA","SA","21398709",136,108,122,28
"134",2023-06-17,"TNHA-SB","TNHA","SB","21181033",163,153,158,10
"135",2023-06-17,"TNHA-SC","TNHA","SC","21206909",112,101,106.5,11
"136",2023-06-17,"TNHA-SD","TNHA","SD","21398712",344,253,298.5,91
"137",2023-06-18,"BEO-BASE","BEO","BASE","21350855",208,145,176.5,63
"138",2023-06-18,"SSMH-SA","SSMH","SA","21206911",321,298,309.5,23
"139",2023-06-18,"SSMH-SB","SSMH","SB","21206912",338,39,188.5,299
"140",2023-06-18,"TNHA-BASE","TNHA","BASE","21167037",309,211,260,98
"141",2023-06-18,"TNHA-SA","TNHA","SA","21398709",131,114,122.5,17
"142",2023-06-18,"TNHA-SB","TNHA","SB","21181033",170,150,160,20
"143",2023-06-18,"TNHA-SC","TNHA","SC","21206909",295,101,198,194
"144",2023-06-18,"TNHA-SD","TNHA","SD","21398712",354,18,186,336
"145",2023-06-19,"BEO-BASE","BEO","BASE","21350855",354,81,217.5,273
"146",2023-06-19,"SSMH-SA","SSMH","SA","21206911",358,35,196.5,323
"147",2023-06-19,"SSMH-SB","SSMH","SB","21206912",358,0,179,358
"148",2023-06-19,"TNHA-BASE","TNHA","BASE","21167037",306,0,153,306
"149",2023-06-19,"TNHA-SA","TNHA","SA","21398709",319,107,213,212
"150",2023-06-19,"TNHA-SB","TNHA","SB","21181033",164,152,158,12
"151",2023-06-19,"TNHA-SC","TNHA","SC","21206909",354,95,224.5,259
"152",2023-06-19,"TNHA-SD","TNHA","SD","21398712",321,6,163.5,315
"153",2023-06-20,"BEO-BASE","BEO","BASE","21350855",341,6,173.5,335
"154",2023-06-20,"SSMH-SA","SSMH","SA","21206911",317,14,165.5,303
"155",2023-06-20,"SSMH-SB","SSMH","SB","21206912",358,1,179.5,357
"156",2023-06-21,"BEO-BASE","BEO","BASE","21350855",351,295,323,56
"157",2023-06-22,"BEO-BASE","BEO","BASE","21350855",354,0,177,354
"158",2023-06-23,"BEO-BASE","BEO","BASE","21350855",171,42,106.5,129
"159",2023-06-24,"BEO-BASE","BEO","BASE","21350855",218,132,175,86
"160",2023-06-25,"BEO-BASE","BEO","BASE","21350855",152,52,102,100
"161",2023-06-26,"BEO-BASE","BEO","BASE","21350855",157,55,106,102
"162",2023-06-27,"BEO-BASE","BEO","BASE","21350855",357,152,254.5,205
"163",2023-06-28,"BEO-BASE","BEO","BASE","21350855",348,22,185,326
"164",2023-06-28,"SSMH-SA","SSMH","SA","21206911",358,34,196,324
"165",2023-06-28,"SSMH-SB","SSMH","SB","21206912",246,4,125,242
"166",2023-06-29,"BEO-BASE","BEO","BASE","21350855",160,145,152.5,15
"167",2023-06-29,"SSMH-SA","SSMH","SA","21206911",319,295,307,24
"168",2023-06-29,"SSMH-SB","SSMH","SB","21206912",351,10,180.5,341
"169",2023-06-30,"BEO-BASE","BEO","BASE","21350855",154,73,113.5,81
"170",2023-06-30,"SSMH-SA","SSMH","SA","21206911",352,11,181.5,341
"171",2023-06-30,"SSMH-SB","SSMH","SB","21206912",199,52,125.5,147
"172",2023-07-01,"BEO-BASE","BEO","BASE","21350855",352,8,180,344
"173",2023-07-01,"SSMH-SA","SSMH","SA","21206911",358,14,186,344
"174",2023-07-01,"SSMH-SB","SSMH","SB","21206912",358,1,179.5,357
"175",2023-07-02,"BEO-BASE","BEO","BASE","21350855",347,29,188,318
"176",2023-07-02,"SSMH-SA","SSMH","SA","21206911",358,32,195,326
"177",2023-07-02,"SSMH-SB","SSMH","SB","21206912",358,1,179.5,357
"178",2023-07-03,"BEO-BASE","BEO","BASE","21350855",180,150,165,30
"179",2023-07-03,"SSMH-SA","SSMH","SA","21206911",350,298,324,52
"180",2023-07-03,"SSMH-SB","SSMH","SB","21206912",204,42,123,162
"181",2023-07-04,"BEO-BASE","BEO","BASE","21350855",358,1,179.5,357
"182",2023-07-04,"SSMH-SA","SSMH","SA","21206911",352,7,179.5,345
"183",2023-07-04,"SSMH-SB","SSMH","SB","21206912",358,3,180.5,355
"184",2023-07-05,"BEO-BASE","BEO","BASE","21350855",357,3,180,354
"185",2023-07-05,"SSMH-SA","SSMH","SA","21206911",136,46,91,90
"186",2023-07-05,"SSMH-SB","SSMH","SB","21206912",358,1,179.5,357
"187",2023-07-06,"BEO-BASE","BEO","BASE","21350855",338,10,174,328
"188",2023-07-06,"SSMH-SA","SSMH","SA","21206911",358,1,179.5,357
"189",2023-07-06,"SSMH-SB","SSMH","SB","21206912",358,1,179.5,357
"190",2023-07-07,"BEO-BASE","BEO","BASE","21350855",163,124,143.5,39
"191",2023-07-07,"SSMH-SA","SSMH","SA","21206911",344,288,316,56
"192",2023-07-07,"SSMH-SB","SSMH","SB","21206912",248,69,158.5,179
"193",2023-07-08,"BEO-BASE","BEO","BASE","21350855",125,13,69,112
"194",2023-07-08,"SSMH-SA","SSMH","SA","21206911",358,0,179,358
"195",2023-07-08,"SSMH-SB","SSMH","SB","21206912",183,31,107,152
"196",2023-07-09,"BEO-BASE","BEO","BASE","21350855",56,3,29.5,53
"197",2023-07-09,"SSMH-SA","SSMH","SA","21206911",351,1,176,350
"198",2023-07-09,"SSMH-SB","SSMH","SB","21206912",147,4,75.5,143
"199",2023-07-09,"TNHA-BASE","TNHA","BASE","21167037",352,44,198,308
"200",2023-07-09,"TNHA-SA","TNHA","SA","21398709",317,307,312,10
"201",2023-07-09,"TNHA-SB","TNHA","SB","21181033",233,208,220.5,25
"202",2023-07-09,"TNHA-SC","TNHA","SC","21206909",334,302,318,32
"203",2023-07-09,"TNHA-SD","TNHA","SD","21398712",149,107,128,42
"204",2023-07-10,"BEO-BASE","BEO","BASE","21350855",173,76,124.5,97
"205",2023-07-10,"SSMH-SA","SSMH","SA","21206911",341,299,320,42
"206",2023-07-10,"SSMH-SB","SSMH","SB","21206912",208,70,139,138
"207",2023-07-10,"TNHA-BASE","TNHA","BASE","21167037",358,8,183,350
"208",2023-07-10,"TNHA-SA","TNHA","SA","21398709",317,49,183,268
"209",2023-07-10,"TNHA-SB","TNHA","SB","21181033",258,184,221,74
"210",2023-07-10,"TNHA-SC","TNHA","SC","21206909",293,52,172.5,241
"211",2023-07-10,"TNHA-SD","TNHA","SD","21398712",312,161,236.5,151
"212",2023-07-11,"BEO-BASE","BEO","BASE","21350855",351,143,247,208
"213",2023-07-11,"SSMH-SA","SSMH","SA","21206911",348,32,190,316
"214",2023-07-11,"SSMH-SB","SSMH","SB","21206912",358,0,179,358
"215",2023-07-11,"TNHA-BASE","TNHA","BASE","21167037",344,13,178.5,331
"216",2023-07-11,"TNHA-SA","TNHA","SA","21398709",316,102,209,214
"217",2023-07-11,"TNHA-SB","TNHA","SB","21181033",211,197,204,14
"218",2023-07-11,"TNHA-SC","TNHA","SC","21206909",350,70,210,280
"219",2023-07-11,"TNHA-SD","TNHA","SD","21398712",303,66,184.5,237
"220",2023-07-12,"BEO-BASE","BEO","BASE","21350855",352,0,176,352
"221",2023-07-12,"SSMH-SA","SSMH","SA","21206911",98,52,75,46
"222",2023-07-12,"SSMH-SB","SSMH","SB","21206912",358,4,181,354
"223",2023-07-12,"TNHA-BASE","TNHA","BASE","21167037",358,1,179.5,357
"224",2023-07-12,"TNHA-SA","TNHA","SA","21398709",317,289,303,28
"225",2023-07-12,"TNHA-SB","TNHA","SB","21181033",215,202,208.5,13
"226",2023-07-12,"TNHA-SC","TNHA","SC","21206909",358,295,326.5,63
"227",2023-07-12,"TNHA-SD","TNHA","SD","21398712",195,104,149.5,91
"228",2023-07-13,"BEO-BASE","BEO","BASE","21350855",138,17,77.5,121
"229",2023-07-13,"SSMH-SA","SSMH","SA","21206911",358,0,179,358
"230",2023-07-13,"SSMH-SB","SSMH","SB","21206912",188,69,128.5,119
"231",2023-07-13,"TNHA-BASE","TNHA","BASE","21167037",358,3,180.5,355
"232",2023-07-13,"TNHA-SA","TNHA","SA","21398709",321,104,212.5,217
"233",2023-07-13,"TNHA-SB","TNHA","SB","21181033",213,202,207.5,11
"234",2023-07-13,"TNHA-SC","TNHA","SC","21206909",358,4,181,354
"235",2023-07-13,"TNHA-SD","TNHA","SD","21398712",275,114,194.5,161
"236",2023-07-14,"BEO-BASE","BEO","BASE","21350855",136,111,123.5,25
"237",2023-07-14,"SSMH-SA","SSMH","SA","21206911",345,286,315.5,59
"238",2023-07-14,"SSMH-SB","SSMH","SB","21206912",232,153,192.5,79
"239",2023-07-14,"TNHA-BASE","TNHA","BASE","21167037",355,0,177.5,355
"240",2023-07-14,"TNHA-SA","TNHA","SA","21398709",143,112,127.5,31
"241",2023-07-14,"TNHA-SB","TNHA","SB","21181033",264,177,220.5,87
"242",2023-07-14,"TNHA-SC","TNHA","SC","21206909",111,107,109,4
"243",2023-07-14,"TNHA-SD","TNHA","SD","21398712",264,244,254,20
"244",2023-07-15,"SSMH-SA","SSMH","SA","21206911",352,352,352,0
"245",2023-07-15,"SSMH-SB","SSMH","SB","21206912",161,161,161,0
"246",2023-07-15,"TNHA-BASE","TNHA","BASE","21167037",4,4,4,0
"247",2023-07-15,"TNHA-SA","TNHA","SA","21398709",114,114,114,0
"248",2023-07-15,"TNHA-SB","TNHA","SB","21181033",204,204,204,0
"249",2023-07-15,"TNHA-SC","TNHA","SC","21206909",105,105,105,0
"250",2023-07-15,"TNHA-SD","TNHA","SD","21398712",247,247,247,0
