"","Date","fullname","site","station","sensor","max","min","avg","amp"
"1",2023-03-05,"BEO-BASE","BEO","BASE","21350855",194,167,180.5,27
"2",2023-03-05,"SSMH-SB","SSMH","SB","21206912",102,95,98.5,7
"3",2023-03-05,"TNHA-BASE","TNHA","BASE","21167037",232,218,225,14
"4",2023-03-05,"TNHA-SA","TNHA","SA","21398709",143,114,128.5,29
"5",2023-03-05,"TNHA-SB","TNHA","SB","21181033",358,358,358,0
"6",2023-03-05,"TNHA-SC","TNHA","SC","21206909",285,275,280,10
"7",2023-03-05,"TNHA-SD","TNHA","SD","21398712",357,354,355.5,3
"8",2023-03-06,"BEO-BASE","BEO","BASE","21350855",198,190,194,8
"9",2023-03-06,"SSMH-SB","SSMH","SB","21206912",112,95,103.5,17
"10",2023-03-06,"TNHA-BASE","TNHA","BASE","21167037",300,234,267,66
"11",2023-03-06,"TNHA-SA","TNHA","SA","21398709",104,101,102.5,3
"12",2023-03-06,"TNHA-SB","TNHA","SB","21181033",358,211,284.5,147
"13",2023-03-06,"TNHA-SC","TNHA","SC","21206909",288,281,284.5,7
"14",2023-03-06,"TNHA-SD","TNHA","SD","21398712",358,1,179.5,357
"15",2023-03-07,"BEO-BASE","BEO","BASE","21350855",236,201,218.5,35
"16",2023-03-07,"SSMH-SB","SSMH","SB","21206912",112,58,85,54
"17",2023-03-07,"TNHA-BASE","TNHA","BASE","21167037",314,257,285.5,57
"18",2023-03-07,"TNHA-SA","TNHA","SA","21398709",114,102,108,12
"19",2023-03-07,"TNHA-SB","TNHA","SB","21181033",225,212,218.5,13
"20",2023-03-07,"TNHA-SC","TNHA","SC","21206909",292,110,201,182
"21",2023-03-07,"TNHA-SD","TNHA","SD","21398712",45,6,25.5,39
"22",2023-03-08,"BEO-BASE","BEO","BASE","21350855",329,234,281.5,95
"23",2023-03-08,"SSMH-SB","SSMH","SB","21206912",327,60,193.5,267
"24",2023-03-08,"TNHA-BASE","TNHA","BASE","21167037",321,254,287.5,67
"25",2023-03-08,"TNHA-SA","TNHA","SA","21398709",288,104,196,184
"26",2023-03-08,"TNHA-SB","TNHA","SB","21181033",271,194,232.5,77
"27",2023-03-08,"TNHA-SC","TNHA","SC","21206909",300,110,205,190
"28",2023-03-08,"TNHA-SD","TNHA","SD","21398712",84,8,46,76
"29",2023-03-09,"BEO-BASE","BEO","BASE","21350855",358,1,179.5,357
"30",2023-03-09,"SSMH-SB","SSMH","SB","21206912",27,14,20.5,13
"31",2023-03-09,"TNHA-BASE","TNHA","BASE","21167037",344,317,330.5,27
"32",2023-03-09,"TNHA-SA","TNHA","SA","21398709",313,307,310,6
"33",2023-03-09,"TNHA-SB","TNHA","SB","21181033",358,312,335,46
"34",2023-03-09,"TNHA-SC","TNHA","SC","21206909",296,295,295.5,1
"35",2023-03-09,"TNHA-SD","TNHA","SD","21398712",79,73,76,6
"36",2023-03-10,"BEO-BASE","BEO","BASE","21350855",281,212,246.5,69
"37",2023-03-10,"SSMH-SB","SSMH","SB","21206912",58,28,43,30
"38",2023-03-10,"TNHA-BASE","TNHA","BASE","21167037",336,295,315.5,41
"39",2023-03-10,"TNHA-SA","TNHA","SA","21398709",312,104,208,208
"40",2023-03-10,"TNHA-SB","TNHA","SB","21181033",358,350,354,8
"41",2023-03-10,"TNHA-SC","TNHA","SC","21206909",344,107,225.5,237
"42",2023-03-10,"TNHA-SD","TNHA","SD","21398712",73,35,54,38
"43",2023-03-11,"BEO-BASE","BEO","BASE","21350855",355,3,179,352
"44",2023-03-11,"SSMH-SB","SSMH","SB","21206912",46,14,30,32
"45",2023-03-11,"TNHA-BASE","TNHA","BASE","21167037",340,77,208.5,263
"46",2023-03-11,"TNHA-SA","TNHA","SA","21398709",309,118,213.5,191
"47",2023-03-11,"TNHA-SB","TNHA","SB","21181033",358,327,342.5,31
"48",2023-03-11,"TNHA-SC","TNHA","SC","21206909",309,108,208.5,201
"49",2023-03-11,"TNHA-SD","TNHA","SD","21398712",77,59,68,18
"50",2023-03-12,"BEO-BASE","BEO","BASE","21350855",341,329,335,12
"51",2023-03-12,"SSMH-SB","SSMH","SB","21206912",28,8,18,20
"52",2023-03-12,"TNHA-BASE","TNHA","BASE","21167037",69,7,38,62
"53",2023-03-12,"TNHA-SA","TNHA","SA","21398709",310,307,308.5,3
"54",2023-03-12,"TNHA-SB","TNHA","SB","21181033",358,358,358,0
"55",2023-03-12,"TNHA-SC","TNHA","SC","21206909",299,295,297,4
"56",2023-03-12,"TNHA-SD","TNHA","SD","21398712",73,58,65.5,15
"57",2023-03-13,"BEO-BASE","BEO","BASE","21350855",355,337,346,18
"58",2023-03-13,"SSMH-SB","SSMH","SB","21206912",52,20,36,32
"59",2023-03-13,"TNHA-BASE","TNHA","BASE","21167037",336,326,331,10
"60",2023-03-13,"TNHA-SA","TNHA","SA","21398709",312,309,310.5,3
"61",2023-03-13,"TNHA-SB","TNHA","SB","21181033",358,358,358,0
"62",2023-03-13,"TNHA-SC","TNHA","SC","21206909",296,295,295.5,1
"63",2023-03-13,"TNHA-SD","TNHA","SD","21398712",83,77,80,6
"64",2023-03-14,"BEO-BASE","BEO","BASE","21350855",49,3,26,46
"65",2023-03-14,"SSMH-SB","SSMH","SB","21206912",159,117,138,42
"66",2023-03-14,"TNHA-BASE","TNHA","BASE","21167037",331,330,330.5,1
"67",2023-03-14,"TNHA-SA","TNHA","SA","21398709",340,52,196,288
"68",2023-03-14,"TNHA-SB","TNHA","SB","21181033",358,358,358,0
"69",2023-03-14,"TNHA-SC","TNHA","SC","21206909",319,39,179,280
"70",2023-03-14,"TNHA-SD","TNHA","SD","21398712",247,124,185.5,123
"71",2023-03-15,"BEO-BASE","BEO","BASE","21350855",324,3,163.5,321
"72",2023-03-15,"SSMH-SB","SSMH","SB","21206912",355,45,200,310
"73",2023-03-15,"TNHA-BASE","TNHA","BASE","21167037",350,1,175.5,349
"74",2023-03-15,"TNHA-SA","TNHA","SA","21398709",320,282,301,38
"75",2023-03-15,"TNHA-SB","TNHA","SB","21181033",358,358,358,0
"76",2023-03-15,"TNHA-SC","TNHA","SC","21206909",327,104,215.5,223
"77",2023-03-15,"TNHA-SD","TNHA","SD","21398712",81,53,67,28
"78",2023-03-16,"BEO-BASE","BEO","BASE","21350855",279,267,273,12
"79",2023-03-16,"SSMH-SB","SSMH","SB","21206912",21,6,13.5,15
"80",2023-03-16,"TNHA-BASE","TNHA","BASE","21167037",345,326,335.5,19
"81",2023-03-16,"TNHA-SA","TNHA","SA","21398709",286,140,213,146
"82",2023-03-16,"TNHA-SB","TNHA","SB","21181033",358,358,358,0
"83",2023-03-16,"TNHA-SC","TNHA","SC","21206909",112,112,112,0
"84",2023-03-16,"TNHA-SD","TNHA","SD","21398712",93,80,86.5,13
"85",2023-03-17,"BEO-BASE","BEO","BASE","21350855",268,251,259.5,17
"86",2023-03-17,"SSMH-SA","SSMH","SA","21206911",354,17,185.5,337
"87",2023-03-17,"SSMH-SB","SSMH","SB","21206912",91,39,65,52
"88",2023-03-17,"TNHA-BASE","TNHA","BASE","21167037",330,314,322,16
"89",2023-03-17,"TNHA-SA","TNHA","SA","21398709",272,66,169,206
"90",2023-03-17,"TNHA-SB","TNHA","SB","21181033",358,358,358,0
"91",2023-03-17,"TNHA-SC","TNHA","SC","21206909",115,112,113.5,3
"92",2023-03-17,"TNHA-SD","TNHA","SD","21398712",93,56,74.5,37
"93",2023-03-18,"BEO-BASE","BEO","BASE","21350855",257,180,218.5,77
"94",2023-03-18,"SSMH-SB","SSMH","SB","21206912",118,29,73.5,89
"95",2023-03-18,"TNHA-BASE","TNHA","BASE","21167037",321,227,274,94
"96",2023-03-18,"TNHA-SA","TNHA","SA","21398709",124,100,112,24
"97",2023-03-18,"TNHA-SB","TNHA","SB","21181033",358,358,358,0
"98",2023-03-18,"TNHA-SC","TNHA","SC","21206909",319,105,212,214
"99",2023-03-18,"TNHA-SD","TNHA","SD","21398712",358,1,179.5,357
"100",2023-03-19,"BEO-BASE","BEO","BASE","21350855",191,164,177.5,27
"101",2023-03-19,"SSMH-SB","SSMH","SB","21206912",114,105,109.5,9
"102",2023-03-19,"TNHA-BASE","TNHA","BASE","21167037",246,219,232.5,27
"103",2023-03-19,"TNHA-SA","TNHA","SA","21398709",114,98,106,16
"104",2023-03-19,"TNHA-SB","TNHA","SB","21181033",358,1,179.5,357
"105",2023-03-19,"TNHA-SC","TNHA","SC","21206909",291,93,192,198
"106",2023-03-19,"TNHA-SD","TNHA","SD","21398712",358,1,179.5,357
"107",2023-03-20,"BEO-BASE","BEO","BASE","21350855",258,171,214.5,87
"108",2023-03-20,"SSMH-SB","SSMH","SB","21206912",104,74,89,30
"109",2023-03-20,"TNHA-BASE","TNHA","BASE","21167037",343,220,281.5,123
"110",2023-03-20,"TNHA-SA","TNHA","SA","21398709",121,97,109,24
"111",2023-03-20,"TNHA-SB","TNHA","SB","21181033",358,159,258.5,199
"112",2023-03-20,"TNHA-SC","TNHA","SC","21206909",314,67,190.5,247
"113",2023-03-20,"TNHA-SD","TNHA","SD","21398712",358,6,182,352
"114",2023-03-21,"BEO-BASE","BEO","BASE","21350855",232,159,195.5,73
"115",2023-03-21,"SSMH-SB","SSMH","SB","21206912",230,90,160,140
"116",2023-03-21,"TNHA-BASE","TNHA","BASE","21167037",309,219,264,90
"117",2023-03-21,"TNHA-SA","TNHA","SA","21398709",114,100,107,14
"118",2023-03-21,"TNHA-SB","TNHA","SB","21181033",358,21,189.5,337
"119",2023-03-21,"TNHA-SC","TNHA","SC","21206909",298,102,200,196
"120",2023-03-21,"TNHA-SD","TNHA","SD","21398712",358,3,180.5,355
"121",2023-03-22,"BEO-BASE","BEO","BASE","21350855",277,101,189,176
"122",2023-03-22,"SSMH-SB","SSMH","SB","21206912",188,55,121.5,133
"123",2023-03-22,"TNHA-BASE","TNHA","BASE","21167037",330,178,254,152
"124",2023-03-22,"TNHA-SA","TNHA","SA","21398709",125,97,111,28
"125",2023-03-22,"TNHA-SB","TNHA","SB","21181033",358,45,201.5,313
"126",2023-03-22,"TNHA-SC","TNHA","SC","21206909",347,1,174,346
"127",2023-03-22,"TNHA-SD","TNHA","SD","21398712",357,20,188.5,337
"128",2023-03-23,"BEO-BASE","BEO","BASE","21350855",161,110,135.5,51
"129",2023-03-23,"SSMH-SA","SSMH","SA","21206911",303,303,303,0
"130",2023-03-23,"SSMH-SB","SSMH","SB","21206912",185,111,148,74
"131",2023-03-23,"TNHA-BASE","TNHA","BASE","21167037",222,55,138.5,167
"132",2023-03-23,"TNHA-SA","TNHA","SA","21398709",177,91,134,86
"133",2023-03-23,"TNHA-SB","TNHA","SB","21181033",358,6,182,352
"134",2023-03-23,"TNHA-SC","TNHA","SC","21206909",277,21,149,256
"135",2023-03-23,"TNHA-SD","TNHA","SD","21398712",355,244,299.5,111
"136",2023-03-24,"BEO-BASE","BEO","BASE","21350855",336,147,241.5,189
"137",2023-03-24,"TNHA-BASE","TNHA","BASE","21167037",330,15,172.5,315
"138",2023-03-24,"TNHA-SA","TNHA","SA","21398709",307,100,203.5,207
"139",2023-03-24,"TNHA-SB","TNHA","SB","21181033",358,56,207,302
"140",2023-03-24,"TNHA-SC","TNHA","SC","21206909",299,83,191,216
"141",2023-03-24,"TNHA-SD","TNHA","SD","21398712",355,8,181.5,347
"142",2023-03-25,"BEO-BASE","BEO","BASE","21350855",300,202,251,98
"143",2023-03-25,"TNHA-BASE","TNHA","BASE","21167037",330,241,285.5,89
"144",2023-03-25,"TNHA-SA","TNHA","SA","21398709",305,102,203.5,203
"145",2023-03-25,"TNHA-SB","TNHA","SB","21181033",358,358,358,0
"146",2023-03-25,"TNHA-SC","TNHA","SC","21206909",310,98,204,212
"147",2023-03-25,"TNHA-SD","TNHA","SD","21398712",98,17,57.5,81
"148",2023-03-26,"BEO-BASE","BEO","BASE","21350855",265,205,235,60
"149",2023-03-26,"TNHA-BASE","TNHA","BASE","21167037",321,288,304.5,33
"150",2023-03-26,"TNHA-SA","TNHA","SA","21398709",122,104,113,18
"151",2023-03-26,"TNHA-SB","TNHA","SB","21181033",358,219,288.5,139
"152",2023-03-26,"TNHA-SC","TNHA","SC","21206909",302,97,199.5,205
"153",2023-03-26,"TNHA-SD","TNHA","SD","21398712",100,20,60,80
"154",2023-03-27,"BEO-BASE","BEO","BASE","21350855",329,246,287.5,83
"155",2023-03-27,"TNHA-BASE","TNHA","BASE","21167037",350,14,182,336
"156",2023-03-27,"TNHA-SA","TNHA","SA","21398709",324,87,205.5,237
"157",2023-03-27,"TNHA-SB","TNHA","SB","21181033",358,229,293.5,129
"158",2023-03-27,"TNHA-SC","TNHA","SC","21206909",302,107,204.5,195
"159",2023-03-27,"TNHA-SD","TNHA","SD","21398712",110,31,70.5,79
"160",2023-03-28,"BEO-BASE","BEO","BASE","21350855",337,271,304,66
"161",2023-03-28,"TNHA-BASE","TNHA","BASE","21167037",358,0,179,358
"162",2023-03-28,"TNHA-SA","TNHA","SA","21398709",313,131,222,182
"163",2023-03-28,"TNHA-SB","TNHA","SB","21181033",358,288,323,70
"164",2023-03-28,"TNHA-SC","TNHA","SC","21206909",320,25,172.5,295
"165",2023-03-28,"TNHA-SD","TNHA","SD","21398712",98,3,50.5,95
"166",2023-03-29,"BEO-BASE","BEO","BASE","21350855",289,185,237,104
"167",2023-03-29,"TNHA-BASE","TNHA","BASE","21167037",333,230,281.5,103
"168",2023-03-29,"TNHA-SA","TNHA","SA","21398709",300,97,198.5,203
"169",2023-03-29,"TNHA-SB","TNHA","SB","21181033",358,358,358,0
"170",2023-03-29,"TNHA-SC","TNHA","SC","21206909",286,93,189.5,193
"171",2023-03-29,"TNHA-SD","TNHA","SD","21398712",354,17,185.5,337
"172",2023-03-30,"BEO-BASE","BEO","BASE","21350855",187,157,172,30
"173",2023-03-30,"TNHA-BASE","TNHA","BASE","21167037",233,208,220.5,25
"174",2023-03-30,"TNHA-SA","TNHA","SA","21398709",112,100,106,12
"175",2023-03-30,"TNHA-SB","TNHA","SB","21181033",358,38,198,320
"176",2023-03-30,"TNHA-SC","TNHA","SC","21206909",286,53,169.5,233
"177",2023-03-30,"TNHA-SD","TNHA","SD","21398712",357,274,315.5,83
"178",2023-03-31,"BEO-BASE","BEO","BASE","21350855",354,11,182.5,343
"179",2023-03-31,"TNHA-BASE","TNHA","BASE","21167037",352,22,187,330
"180",2023-03-31,"TNHA-SA","TNHA","SA","21398709",312,52,182,260
"181",2023-03-31,"TNHA-SB","TNHA","SB","21181033",358,114,236,244
"182",2023-03-31,"TNHA-SC","TNHA","SC","21206909",357,14,185.5,343
"183",2023-03-31,"TNHA-SD","TNHA","SD","21398712",357,10,183.5,347
"184",2023-04-01,"BEO-BASE","BEO","BASE","21350855",341,195,268,146
"185",2023-04-01,"TNHA-BASE","TNHA","BASE","21167037",347,31,189,316
"186",2023-04-01,"TNHA-SA","TNHA","SA","21398709",316,58,187,258
"187",2023-04-01,"TNHA-SB","TNHA","SB","21181033",358,358,358,0
"188",2023-04-01,"TNHA-SC","TNHA","SC","21206909",338,83,210.5,255
"189",2023-04-01,"TNHA-SD","TNHA","SD","21398712",358,3,180.5,355
"190",2023-04-02,"BEO-BASE","BEO","BASE","21350855",209,152,180.5,57
"191",2023-04-02,"TNHA-BASE","TNHA","BASE","21167037",254,213,233.5,41
"192",2023-04-02,"TNHA-SA","TNHA","SA","21398709",209,100,154.5,109
"193",2023-04-02,"TNHA-SB","TNHA","SB","21181033",358,357,357.5,1
"194",2023-04-02,"TNHA-SC","TNHA","SC","21206909",289,102,195.5,187
"195",2023-04-02,"TNHA-SD","TNHA","SD","21398712",358,4,181,354
"196",2023-04-03,"BEO-BASE","BEO","BASE","21350855",338,237,287.5,101
"197",2023-04-03,"SSMH-SB","SSMH","SB","21206912",338,299,318.5,39
"198",2023-04-03,"TNHA-BASE","TNHA","BASE","21167037",354,11,182.5,343
"199",2023-04-03,"TNHA-SA","TNHA","SA","21398709",313,105,209,208
"200",2023-04-03,"TNHA-SB","TNHA","SB","21181033",358,358,358,0
"201",2023-04-03,"TNHA-SC","TNHA","SC","21206909",305,59,182,246
"202",2023-04-03,"TNHA-SD","TNHA","SD","21398712",111,32,71.5,79
"203",2023-04-04,"BEO-BASE","BEO","BASE","21350855",347,285,316,62
"204",2023-04-04,"SSMH-SA","SSMH","SA","21206911",104,84,94,20
"205",2023-04-04,"SSMH-SB","SSMH","SB","21206912",358,1,179.5,357
"206",2023-04-04,"TNHA-BASE","TNHA","BASE","21167037",343,0,171.5,343
"207",2023-04-04,"TNHA-SA","TNHA","SA","21398709",312,284,298,28
"208",2023-04-04,"TNHA-SB","TNHA","SB","21181033",358,358,358,0
"209",2023-04-04,"TNHA-SC","TNHA","SC","21206909",310,100,205,210
"210",2023-04-04,"TNHA-SD","TNHA","SD","21398712",143,10,76.5,133
"211",2023-04-05,"BEO-BASE","BEO","BASE","21350855",350,4,177,346
"212",2023-04-05,"SSMH-SA","SSMH","SA","21206911",358,3,180.5,355
"213",2023-04-05,"SSMH-SB","SSMH","SB","21206912",358,1,179.5,357
"214",2023-04-05,"TNHA-BASE","TNHA","BASE","21167037",357,8,182.5,349
"215",2023-04-05,"TNHA-SA","TNHA","SA","21398709",313,300,306.5,13
"216",2023-04-05,"TNHA-SB","TNHA","SB","21181033",358,358,358,0
"217",2023-04-05,"TNHA-SC","TNHA","SC","21206909",316,295,305.5,21
"218",2023-04-05,"TNHA-SD","TNHA","SD","21398712",86,46,66,40
"219",2023-04-06,"BEO-BASE","BEO","BASE","21350855",59,21,40,38
"220",2023-04-06,"SSMH-SA","SSMH","SA","21206911",91,20,55.5,71
"221",2023-04-06,"SSMH-SB","SSMH","SB","21206912",161,76,118.5,85
"222",2023-04-06,"TNHA-BASE","TNHA","BASE","21167037",350,309,329.5,41
"223",2023-04-06,"TNHA-SA","TNHA","SA","21398709",307,0,153.5,307
"224",2023-04-06,"TNHA-SB","TNHA","SB","21181033",358,357,357.5,1
"225",2023-04-06,"TNHA-SC","TNHA","SC","21206909",343,3,173,340
"226",2023-04-06,"TNHA-SD","TNHA","SD","21398712",205,86,145.5,119
"227",2023-04-07,"BEO-BASE","BEO","BASE","21350855",51,11,31,40
"228",2023-04-07,"SSMH-SA","SSMH","SA","21206911",358,0,179,358
"229",2023-04-07,"SSMH-SB","SSMH","SB","21206912",153,1,77,152
"230",2023-04-07,"TNHA-BASE","TNHA","BASE","21167037",341,204,272.5,137
"231",2023-04-07,"TNHA-SA","TNHA","SA","21398709",352,15,183.5,337
"232",2023-04-07,"TNHA-SB","TNHA","SB","21181033",358,24,191,334
"233",2023-04-07,"TNHA-SC","TNHA","SC","21206909",358,17,187.5,341
"234",2023-04-07,"TNHA-SD","TNHA","SD","21398712",358,29,193.5,329
"235",2023-04-08,"BEO-BASE","BEO","BASE","21350855",358,4,181,354
"236",2023-04-08,"SSMH-SA","SSMH","SA","21206911",358,7,182.5,351
"237",2023-04-08,"SSMH-SB","SSMH","SB","21206912",358,1,179.5,357
"238",2023-04-08,"TNHA-BASE","TNHA","BASE","21167037",343,24,183.5,319
"239",2023-04-08,"TNHA-SA","TNHA","SA","21398709",310,124,217,186
"240",2023-04-08,"TNHA-SB","TNHA","SB","21181033",358,358,358,0
"241",2023-04-08,"TNHA-SC","TNHA","SC","21206909",306,107,206.5,199
"242",2023-04-08,"TNHA-SD","TNHA","SD","21398712",93,14,53.5,79
"243",2023-04-09,"BEO-BASE","BEO","BASE","21350855",261,73,167,188
"244",2023-04-09,"SSMH-SA","SSMH","SA","21206911",358,0,179,358
"245",2023-04-09,"SSMH-SB","SSMH","SB","21206912",204,39,121.5,165
"246",2023-04-09,"TNHA-BASE","TNHA","BASE","21167037",348,307,327.5,41
"247",2023-04-09,"TNHA-SA","TNHA","SA","21398709",147,84,115.5,63
"248",2023-04-09,"TNHA-SB","TNHA","SB","21181033",358,358,358,0
"249",2023-04-09,"TNHA-SC","TNHA","SC","21206909",117,101,109,16
"250",2023-04-09,"TNHA-SD","TNHA","SD","21398712",227,31,129,196
"251",2023-04-10,"BEO-BASE","BEO","BASE","21350855",333,29,181,304
"252",2023-04-10,"SSMH-SA","SSMH","SA","21206911",358,0,179,358
"253",2023-04-10,"SSMH-SB","SSMH","SB","21206912",358,1,179.5,357
"254",2023-04-10,"TNHA-BASE","TNHA","BASE","21167037",357,10,183.5,347
"255",2023-04-10,"TNHA-SA","TNHA","SA","21398709",317,121,219,196
"256",2023-04-10,"TNHA-SB","TNHA","SB","21181033",358,358,358,0
"257",2023-04-10,"TNHA-SC","TNHA","SC","21206909",358,91,224.5,267
"258",2023-04-10,"TNHA-SD","TNHA","SD","21398712",239,20,129.5,219
"259",2023-04-11,"BEO-BASE","BEO","BASE","21350855",330,272,301,58
"260",2023-04-11,"SSMH-SA","SSMH","SA","21206911",110,70,90,40
"261",2023-04-11,"SSMH-SB","SSMH","SB","21206912",358,1,179.5,357
"262",2023-04-11,"TNHA-BASE","TNHA","BASE","21167037",343,1,172,342
"263",2023-04-11,"TNHA-SA","TNHA","SA","21398709",309,178,243.5,131
"264",2023-04-11,"TNHA-SB","TNHA","SB","21181033",358,358,358,0
"265",2023-04-11,"TNHA-SC","TNHA","SC","21206909",300,65,182.5,235
"266",2023-04-11,"TNHA-SD","TNHA","SD","21398712",98,17,57.5,81
"267",2023-04-12,"BEO-BASE","BEO","BASE","21350855",343,11,177,332
"268",2023-04-12,"SSMH-SA","SSMH","SA","21206911",352,1,176.5,351
"269",2023-04-12,"SSMH-SB","SSMH","SB","21206912",358,0,179,358
"270",2023-04-12,"TNHA-BASE","TNHA","BASE","21167037",347,31,189,316
"271",2023-04-12,"TNHA-SA","TNHA","SA","21398709",306,277,291.5,29
"272",2023-04-12,"TNHA-SB","TNHA","SB","21181033",358,358,358,0
"273",2023-04-12,"TNHA-SC","TNHA","SC","21206909",334,86,210,248
"274",2023-04-12,"TNHA-SD","TNHA","SD","21398712",115,1,58,114
"275",2023-04-13,"BEO-BASE","BEO","BASE","21350855",44,3,23.5,41
"276",2023-04-13,"SSMH-SA","SSMH","SA","21206911",358,0,179,358
"277",2023-04-13,"SSMH-SB","SSMH","SB","21206912",161,14,87.5,147
"278",2023-04-13,"TNHA-BASE","TNHA","BASE","21167037",354,314,334,40
"279",2023-04-13,"TNHA-SA","TNHA","SA","21398709",305,278,291.5,27
"280",2023-04-13,"TNHA-SB","TNHA","SB","21181033",358,358,358,0
"281",2023-04-13,"TNHA-SC","TNHA","SC","21206909",337,18,177.5,319
"282",2023-04-13,"TNHA-SD","TNHA","SD","21398712",128,69,98.5,59
"283",2023-04-14,"BEO-BASE","BEO","BASE","21350855",62,32,47,30
"284",2023-04-14,"SSMH-SA","SSMH","SA","21206911",105,0,52.5,105
"285",2023-04-14,"SSMH-SB","SSMH","SB","21206912",181,101,141,80
"286",2023-04-14,"TNHA-BASE","TNHA","BASE","21167037",344,314,329,30
"287",2023-04-14,"TNHA-SA","TNHA","SA","21398709",329,281,305,48
"288",2023-04-14,"TNHA-SB","TNHA","SB","21181033",358,358,358,0
"289",2023-04-14,"TNHA-SC","TNHA","SC","21206909",358,6,182,352
"290",2023-04-14,"TNHA-SD","TNHA","SD","21398712",230,108,169,122
"291",2023-04-15,"BEO-BASE","BEO","BASE","21350855",67,34,50.5,33
"292",2023-04-15,"SSMH-SA","SSMH","SA","21206911",358,0,179,358
"293",2023-04-15,"SSMH-SB","SSMH","SB","21206912",174,132,153,42
"294",2023-04-15,"TNHA-BASE","TNHA","BASE","21167037",344,329,336.5,15
"295",2023-04-15,"TNHA-SA","TNHA","SA","21398709",358,15,186.5,343
"296",2023-04-15,"TNHA-SB","TNHA","SB","21181033",358,358,358,0
"297",2023-04-15,"TNHA-SC","TNHA","SC","21206909",358,22,190,336
"298",2023-04-15,"TNHA-SD","TNHA","SD","21398712",333,60,196.5,273
"299",2023-04-16,"BEO-BASE","BEO","BASE","21350855",81,31,56,50
"300",2023-04-16,"SSMH-SA","SSMH","SA","21206911",102,0,51,102
"301",2023-04-16,"SSMH-SB","SSMH","SB","21206912",171,91,131,80
"302",2023-04-16,"TNHA-BASE","TNHA","BASE","21167037",340,319,329.5,21
"303",2023-04-16,"TNHA-SA","TNHA","SA","21398709",300,18,159,282
"304",2023-04-16,"TNHA-SB","TNHA","SB","21181033",358,358,358,0
"305",2023-04-16,"TNHA-SC","TNHA","SC","21206909",358,8,183,350
"306",2023-04-16,"TNHA-SD","TNHA","SD","21398712",277,37,157,240
"307",2023-04-17,"BEO-BASE","BEO","BASE","21350855",357,1,179,356
"308",2023-04-17,"SSMH-SA","SSMH","SA","21206911",358,4,181,354
"309",2023-04-17,"SSMH-SB","SSMH","SB","21206912",358,1,179.5,357
"310",2023-04-17,"TNHA-BASE","TNHA","BASE","21167037",358,3,180.5,355
"311",2023-04-17,"TNHA-SA","TNHA","SA","21398709",303,206,254.5,97
"312",2023-04-17,"TNHA-SB","TNHA","SB","21181033",358,358,358,0
"313",2023-04-17,"TNHA-SC","TNHA","SC","21206909",338,3,170.5,335
"314",2023-04-17,"TNHA-SD","TNHA","SD","21398712",330,46,188,284
"315",2023-04-18,"BEO-BASE","BEO","BASE","21350855",296,226,261,70
"316",2023-04-18,"SSMH-SA","SSMH","SA","21206911",358,1,179.5,357
"317",2023-04-18,"SSMH-SB","SSMH","SB","21206912",358,1,179.5,357
"318",2023-04-18,"TNHA-BASE","TNHA","BASE","21167037",329,244,286.5,85
"319",2023-04-18,"TNHA-SA","TNHA","SA","21398709",295,101,198,194
"320",2023-04-18,"TNHA-SB","TNHA","SB","21181033",358,358,358,0
"321",2023-04-18,"TNHA-SC","TNHA","SC","21206909",117,97,107,20
"322",2023-04-18,"TNHA-SD","TNHA","SD","21398712",93,18,55.5,75
"323",2023-04-19,"BEO-BASE","BEO","BASE","21350855",292,222,257,70
"324",2023-04-19,"SSMH-SA","SSMH","SA","21206911",358,1,179.5,357
"325",2023-04-19,"SSMH-SB","SSMH","SB","21206912",358,1,179.5,357
"326",2023-04-19,"TNHA-BASE","TNHA","BASE","21167037",355,282,318.5,73
"327",2023-04-19,"TNHA-SA","TNHA","SA","21398709",286,100,193,186
"328",2023-04-19,"TNHA-SB","TNHA","SB","21181033",358,358,358,0
"329",2023-04-19,"TNHA-SC","TNHA","SC","21206909",117,98,107.5,19
"330",2023-04-19,"TNHA-SD","TNHA","SD","21398712",93,15,54,78
"331",2023-04-20,"BEO-BASE","BEO","BASE","21350855",279,166,222.5,113
"332",2023-04-20,"SSMH-SA","SSMH","SA","21206911",358,8,183,350
"333",2023-04-20,"SSMH-SB","SSMH","SB","21206912",358,0,179,358
"334",2023-04-20,"TNHA-BASE","TNHA","BASE","21167037",337,220,278.5,117
"335",2023-04-20,"TNHA-SA","TNHA","SA","21398709",289,93,191,196
"336",2023-04-20,"TNHA-SB","TNHA","SB","21181033",358,91,224.5,267
"337",2023-04-20,"TNHA-SC","TNHA","SC","21206909",314,102,208,212
"338",2023-04-20,"TNHA-SD","TNHA","SD","21398712",358,3,180.5,355
"339",2023-04-21,"BEO-BASE","BEO","BASE","21350855",190,107,148.5,83
"340",2023-04-21,"SSMH-SA","SSMH","SA","21206911",358,295,326.5,63
"341",2023-04-21,"SSMH-SB","SSMH","SB","21206912",223,93,158,130
"342",2023-04-21,"TNHA-BASE","TNHA","BASE","21167037",350,11,180.5,339
"343",2023-04-21,"TNHA-SA","TNHA","SA","21398709",135,87,111,48
"344",2023-04-21,"TNHA-SB","TNHA","SB","21181033",358,6,182,352
"345",2023-04-21,"TNHA-SC","TNHA","SC","21206909",284,102,193,182
"346",2023-04-21,"TNHA-SD","TNHA","SD","21398712",355,222,288.5,133
"347",2023-04-22,"BEO-BASE","BEO","BASE","21350855",125,98,111.5,27
"348",2023-04-22,"SSMH-SA","SSMH","SA","21206911",358,1,179.5,357
"349",2023-04-22,"SSMH-SB","SSMH","SB","21206912",222,166,194,56
"350",2023-04-22,"TNHA-BASE","TNHA","BASE","21167037",163,21,92,142
"351",2023-04-22,"TNHA-SA","TNHA","SA","21398709",145,128,136.5,17
"352",2023-04-22,"TNHA-SB","TNHA","SB","21181033",358,271,314.5,87
"353",2023-04-22,"TNHA-SC","TNHA","SC","21206909",110,108,109,2
"354",2023-04-22,"TNHA-SD","TNHA","SD","21398712",254,232,243,22
"355",2023-04-23,"BEO-BASE","BEO","BASE","21350855",122,44,83,78
"356",2023-04-23,"SSMH-SA","SSMH","SA","21206911",358,0,179,358
"357",2023-04-23,"SSMH-SB","SSMH","SB","21206912",223,104,163.5,119
"358",2023-04-23,"TNHA-BASE","TNHA","BASE","21167037",350,17,183.5,333
"359",2023-04-23,"TNHA-SA","TNHA","SA","21398709",345,35,190,310
"360",2023-04-23,"TNHA-SB","TNHA","SB","21181033",358,358,358,0
"361",2023-04-23,"TNHA-SC","TNHA","SC","21206909",352,29,190.5,323
"362",2023-04-23,"TNHA-SD","TNHA","SD","21398712",248,39,143.5,209
"363",2023-04-24,"BEO-BASE","BEO","BASE","21350855",149,110,129.5,39
"364",2023-04-24,"SSMH-SA","SSMH","SA","21206911",337,299,318,38
"365",2023-04-24,"SSMH-SB","SSMH","SB","21206912",239,146,192.5,93
"366",2023-04-24,"TNHA-BASE","TNHA","BASE","21167037",212,18,115,194
"367",2023-04-24,"TNHA-SA","TNHA","SA","21398709",178,102,140,76
"368",2023-04-24,"TNHA-SB","TNHA","SB","21181033",358,156,257,202
"369",2023-04-24,"TNHA-SC","TNHA","SC","21206909",112,107,109.5,5
"370",2023-04-24,"TNHA-SD","TNHA","SD","21398712",288,233,260.5,55
"371",2023-04-25,"BEO-BASE","BEO","BASE","21350855",142,76,109,66
"372",2023-04-25,"SSMH-SA","SSMH","SA","21206911",358,0,179,358
"373",2023-04-25,"SSMH-SB","SSMH","SB","21206912",194,133,163.5,61
"374",2023-04-25,"TNHA-BASE","TNHA","BASE","21167037",330,178,254,152
"375",2023-04-25,"TNHA-SA","TNHA","SA","21398709",124,94,109,30
"376",2023-04-25,"TNHA-SB","TNHA","SB","21181033",183,143,163,40
"377",2023-04-25,"TNHA-SC","TNHA","SC","21206909",323,90,206.5,233
"378",2023-04-25,"TNHA-SD","TNHA","SD","21398712",323,34,178.5,289
"379",2023-04-26,"BEO-BASE","BEO","BASE","21350855",256,191,223.5,65
"380",2023-04-26,"SSMH-SA","SSMH","SA","21206911",358,1,179.5,357
"381",2023-04-26,"SSMH-SB","SSMH","SB","21206912",143,10,76.5,133
"382",2023-04-26,"TNHA-BASE","TNHA","BASE","21167037",354,260,307,94
"383",2023-04-26,"TNHA-SA","TNHA","SA","21398709",173,97,135,76
"384",2023-04-26,"TNHA-SB","TNHA","SB","21181033",195,156,175.5,39
"385",2023-04-26,"TNHA-SC","TNHA","SC","21206909",331,48,189.5,283
"386",2023-04-26,"TNHA-SD","TNHA","SD","21398712",91,32,61.5,59
"387",2023-04-27,"BEO-BASE","BEO","BASE","21350855",175,70,122.5,105
"388",2023-04-27,"SSMH-SA","SSMH","SA","21206911",358,0,179,358
"389",2023-04-27,"SSMH-SB","SSMH","SB","21206912",197,83,140,114
"390",2023-04-27,"TNHA-BASE","TNHA","BASE","21167037",358,1,179.5,357
"391",2023-04-27,"TNHA-SA","TNHA","SA","21398709",128,95,111.5,33
"392",2023-04-27,"TNHA-SB","TNHA","SB","21181033",188,170,179,18
"393",2023-04-27,"TNHA-SC","TNHA","SC","21206909",195,105,150,90
"394",2023-04-27,"TNHA-SD","TNHA","SD","21398712",352,218,285,134
"395",2023-04-28,"BEO-BASE","BEO","BASE","21350855",153,117,135,36
"396",2023-04-28,"SSMH-SA","SSMH","SA","21206911",334,295,314.5,39
"397",2023-04-28,"SSMH-SB","SSMH","SB","21206912",264,98,181,166
"398",2023-04-28,"TNHA-BASE","TNHA","BASE","21167037",218,31,124.5,187
"399",2023-04-28,"TNHA-SA","TNHA","SA","21398709",157,111,134,46
"400",2023-04-28,"TNHA-SB","TNHA","SB","21181033",178,160,169,18
"401",2023-04-28,"TNHA-SC","TNHA","SC","21206909",114,100,107,14
"402",2023-04-28,"TNHA-SD","TNHA","SD","21398712",317,237,277,80
"403",2023-04-29,"BEO-BASE","BEO","BASE","21350855",156,135,145.5,21
"404",2023-04-29,"SSMH-SA","SSMH","SA","21206911",321,295,308,26
"405",2023-04-29,"SSMH-SB","SSMH","SB","21206912",251,86,168.5,165
"406",2023-04-29,"TNHA-BASE","TNHA","BASE","21167037",216,211,213.5,5
"407",2023-04-29,"TNHA-SA","TNHA","SA","21398709",185,129,157,56
"408",2023-04-29,"TNHA-SB","TNHA","SB","21181033",180,161,170.5,19
"409",2023-04-29,"TNHA-SC","TNHA","SC","21206909",112,98,105,14
"410",2023-04-29,"TNHA-SD","TNHA","SD","21398712",306,281,293.5,25
"411",2023-04-30,"BEO-BASE","BEO","BASE","21350855",175,142,158.5,33
"412",2023-04-30,"SSMH-SA","SSMH","SA","21206911",320,296,308,24
"413",2023-04-30,"SSMH-SB","SSMH","SB","21206912",247,84,165.5,163
"414",2023-04-30,"TNHA-BASE","TNHA","BASE","21167037",220,212,216,8
"415",2023-04-30,"TNHA-SA","TNHA","SA","21398709",171,111,141,60
"416",2023-04-30,"TNHA-SB","TNHA","SB","21181033",178,154,166,24
"417",2023-04-30,"TNHA-SC","TNHA","SC","21206909",264,98,181,166
"418",2023-04-30,"TNHA-SD","TNHA","SD","21398712",354,284,319,70
"419",2023-05-01,"BEO-BASE","BEO","BASE","21350855",159,138,148.5,21
"420",2023-05-01,"SSMH-SA","SSMH","SA","21206911",327,289,308,38
"421",2023-05-01,"SSMH-SB","SSMH","SB","21206912",254,76,165,178
"422",2023-05-01,"TNHA-BASE","TNHA","BASE","21167037",218,211,214.5,7
"423",2023-05-01,"TNHA-SA","TNHA","SA","21398709",173,136,154.5,37
"424",2023-05-01,"TNHA-SB","TNHA","SB","21181033",171,161,166,10
"425",2023-05-01,"TNHA-SC","TNHA","SC","21206909",112,100,106,12
"426",2023-05-01,"TNHA-SD","TNHA","SD","21398712",320,275,297.5,45
"427",2023-05-02,"BEO-BASE","BEO","BASE","21350855",150,138,144,12
"428",2023-05-02,"SSMH-SA","SSMH","SA","21206911",330,298,314,32
"429",2023-05-02,"SSMH-SB","SSMH","SB","21206912",267,107,187,160
"430",2023-05-02,"TNHA-BASE","TNHA","BASE","21167037",215,211,213,4
"431",2023-05-02,"TNHA-SA","TNHA","SA","21398709",181,145,163,36
"432",2023-05-02,"TNHA-SB","TNHA","SB","21181033",171,83,127,88
"433",2023-05-02,"TNHA-SC","TNHA","SC","21206909",112,108,110,4
"434",2023-05-02,"TNHA-SD","TNHA","SD","21398712",296,277,286.5,19
"435",2023-05-03,"BEO-BASE","BEO","BASE","21350855",153,135,144,18
"436",2023-05-03,"SSMH-SA","SSMH","SA","21206911",330,300,315,30
"437",2023-05-03,"SSMH-SB","SSMH","SB","21206912",243,90,166.5,153
"438",2023-05-03,"TNHA-BASE","TNHA","BASE","21167037",215,191,203,24
"439",2023-05-03,"TNHA-SA","TNHA","SA","21398709",202,117,159.5,85
"440",2023-05-03,"TNHA-SB","TNHA","SB","21181033",163,157,160,6
"441",2023-05-03,"TNHA-SC","TNHA","SC","21206909",112,102,107,10
"442",2023-05-03,"TNHA-SD","TNHA","SD","21398712",303,267,285,36
"443",2023-05-04,"BEO-BASE","BEO","BASE","21350855",334,20,177,314
"444",2023-05-04,"SSMH-SA","SSMH","SA","21206911",340,39,189.5,301
"445",2023-05-04,"SSMH-SB","SSMH","SB","21206912",358,0,179,358
"446",2023-05-04,"TNHA-BASE","TNHA","BASE","21167037",358,1,179.5,357
"447",2023-05-04,"TNHA-SA","TNHA","SA","21398709",307,117,212,190
"448",2023-05-04,"TNHA-SB","TNHA","SB","21181033",161,156,158.5,5
"449",2023-05-04,"TNHA-SC","TNHA","SC","21206909",347,13,180,334
"450",2023-05-04,"TNHA-SD","TNHA","SD","21398712",282,69,175.5,213
"451",2023-05-05,"BEO-BASE","BEO","BASE","21350855",321,171,246,150
"452",2023-05-05,"SSMH-SA","SSMH","SA","21206911",358,3,180.5,355
"453",2023-05-05,"SSMH-SB","SSMH","SB","21206912",358,1,179.5,357
"454",2023-05-05,"TNHA-BASE","TNHA","BASE","21167037",352,37,194.5,315
"455",2023-05-05,"TNHA-SA","TNHA","SA","21398709",292,100,196,192
"456",2023-05-05,"TNHA-SB","TNHA","SB","21181033",161,157,159,4
"457",2023-05-05,"TNHA-SC","TNHA","SC","21206909",326,98,212,228
"458",2023-05-05,"TNHA-SD","TNHA","SD","21398712",350,4,177,346
"459",2023-05-06,"BEO-BASE","BEO","BASE","21350855",352,59,205.5,293
"460",2023-05-06,"SSMH-SA","SSMH","SA","21206911",358,3,180.5,355
"461",2023-05-06,"SSMH-SB","SSMH","SB","21206912",195,8,101.5,187
"462",2023-05-06,"TNHA-BASE","TNHA","BASE","21167037",350,195,272.5,155
"463",2023-05-06,"TNHA-SA","TNHA","SA","21398709",139,91,115,48
"464",2023-05-06,"TNHA-SB","TNHA","SB","21181033",161,156,158.5,5
"465",2023-05-06,"TNHA-SC","TNHA","SC","21206909",292,4,148,288
"466",2023-05-06,"TNHA-SD","TNHA","SD","21398712",358,0,179,358
"467",2023-05-07,"BEO-BASE","BEO","BASE","21350855",343,60,201.5,283
"468",2023-05-07,"SSMH-SA","SSMH","SA","21206911",358,8,183,350
"469",2023-05-07,"SSMH-SB","SSMH","SB","21206912",358,0,179,358
"470",2023-05-07,"TNHA-BASE","TNHA","BASE","21167037",358,8,183,350
"471",2023-05-07,"TNHA-SA","TNHA","SA","21398709",312,105,208.5,207
"472",2023-05-07,"TNHA-SB","TNHA","SB","21181033",160,156,158,4
"473",2023-05-07,"TNHA-SC","TNHA","SC","21206909",355,31,193,324
"474",2023-05-07,"TNHA-SD","TNHA","SD","21398712",261,41,151,220
"475",2023-05-08,"BEO-BASE","BEO","BASE","21350855",331,197,264,134
"476",2023-05-08,"SSMH-SA","SSMH","SA","21206911",358,7,182.5,351
"477",2023-05-08,"SSMH-SB","SSMH","SB","21206912",358,0,179,358
"478",2023-05-08,"TNHA-BASE","TNHA","BASE","21167037",357,7,182,350
"479",2023-05-08,"TNHA-SA","TNHA","SA","21398709",306,97,201.5,209
"480",2023-05-08,"TNHA-SB","TNHA","SB","21181033",166,157,161.5,9
"481",2023-05-08,"TNHA-SC","TNHA","SC","21206909",324,219,271.5,105
"482",2023-05-08,"TNHA-SD","TNHA","SD","21398712",350,6,178,344
"483",2023-05-09,"BEO-BASE","BEO","BASE","21350855",357,3,180,354
"484",2023-05-09,"SSMH-SA","SSMH","SA","21206911",357,8,182.5,349
"485",2023-05-09,"SSMH-SB","SSMH","SB","21206912",164,6,85,158
"486",2023-05-09,"TNHA-BASE","TNHA","BASE","21167037",352,206,279,146
"487",2023-05-09,"TNHA-SA","TNHA","SA","21398709",306,91,198.5,215
"488",2023-05-09,"TNHA-SB","TNHA","SB","21181033",199,154,176.5,45
"489",2023-05-09,"TNHA-SC","TNHA","SC","21206909",336,51,193.5,285
"490",2023-05-09,"TNHA-SD","TNHA","SD","21398712",358,73,215.5,285
"491",2023-05-10,"BEO-BASE","BEO","BASE","21350855",357,1,179,356
"492",2023-05-10,"SSMH-SA","SSMH","SA","21206911",350,37,193.5,313
"493",2023-05-10,"SSMH-SB","SSMH","SB","21206912",201,3,102,198
"494",2023-05-10,"TNHA-BASE","TNHA","BASE","21167037",350,4,177,346
"495",2023-05-10,"TNHA-SA","TNHA","SA","21398709",351,21,186,330
"496",2023-05-10,"TNHA-SB","TNHA","SB","21181033",161,149,155,12
"497",2023-05-10,"TNHA-SC","TNHA","SC","21206909",341,87,214,254
"498",2023-05-10,"TNHA-SD","TNHA","SD","21398712",316,79,197.5,237
"499",2023-05-11,"BEO-BASE","BEO","BASE","21350855",173,76,124.5,97
"500",2023-05-11,"SSMH-SB","SSMH","SB","21206912",223,73,148,150
"501",2023-05-11,"TNHA-BASE","TNHA","BASE","21167037",352,15,183.5,337
"502",2023-05-11,"TNHA-SA","TNHA","SA","21398709",135,100,117.5,35
"503",2023-05-11,"TNHA-SB","TNHA","SB","21181033",159,147,153,12
"504",2023-05-11,"TNHA-SC","TNHA","SC","21206909",185,102,143.5,83
"505",2023-05-11,"TNHA-SD","TNHA","SD","21398712",355,226,290.5,129
"506",2023-05-12,"BEO-BASE","BEO","BASE","21350855",256,24,140,232
"507",2023-05-12,"SSMH-SB","SSMH","SB","21206912",355,4,179.5,351
"508",2023-05-12,"TNHA-BASE","TNHA","BASE","21167037",351,4,177.5,347
"509",2023-05-12,"TNHA-SA","TNHA","SA","21398709",358,0,179,358
"510",2023-05-12,"TNHA-SB","TNHA","SB","21181033",163,147,155,16
"511",2023-05-12,"TNHA-SC","TNHA","SC","21206909",348,6,177,342
"512",2023-05-12,"TNHA-SD","TNHA","SD","21398712",204,24,114,180
"513",2023-05-13,"BEO-BASE","BEO","BASE","21350855",232,185,208.5,47
"514",2023-05-13,"SSMH-SB","SSMH","SB","21206912",358,27,192.5,331
"515",2023-05-13,"TNHA-BASE","TNHA","BASE","21167037",303,229,266,74
"516",2023-05-13,"TNHA-SA","TNHA","SA","21398709",108,98,103,10
"517",2023-05-13,"TNHA-SB","TNHA","SB","21181033",164,152,158,12
"518",2023-05-13,"TNHA-SC","TNHA","SC","21206909",288,83,185.5,205
"519",2023-05-13,"TNHA-SD","TNHA","SD","21398712",358,24,191,334
"520",2023-05-14,"BEO-BASE","BEO","BASE","21350855",267,188,227.5,79
"521",2023-05-14,"SSMH-SB","SSMH","SB","21206912",204,22,113,182
"522",2023-05-14,"TNHA-BASE","TNHA","BASE","21167037",327,267,297,60
"523",2023-05-14,"TNHA-SA","TNHA","SA","21398709",122,97,109.5,25
"524",2023-05-14,"TNHA-SB","TNHA","SB","21181033",156,150,153,6
"525",2023-05-14,"TNHA-SC","TNHA","SC","21206909",309,35,172,274
"526",2023-05-14,"TNHA-SD","TNHA","SD","21398712",105,18,61.5,87
"527",2023-05-15,"BEO-BASE","BEO","BASE","21350855",347,251,299,96
"528",2023-05-15,"SSMH-SB","SSMH","SB","21206912",358,1,179.5,357
"529",2023-05-15,"TNHA-BASE","TNHA","BASE","21167037",327,183,255,144
"530",2023-05-15,"TNHA-SA","TNHA","SA","21398709",316,115,215.5,201
"531",2023-05-15,"TNHA-SB","TNHA","SB","21181033",161,150,155.5,11
"532",2023-05-15,"TNHA-SC","TNHA","SC","21206909",299,65,182,234
"533",2023-05-15,"TNHA-SD","TNHA","SD","21398712",122,13,67.5,109
"534",2023-05-16,"BEO-BASE","BEO","BASE","21350855",355,14,184.5,341
"535",2023-05-16,"SSMH-SB","SSMH","SB","21206912",222,3,112.5,219
"536",2023-05-16,"TNHA-BASE","TNHA","BASE","21167037",344,8,176,336
"537",2023-05-16,"TNHA-SA","TNHA","SA","21398709",316,60,188,256
"538",2023-05-16,"TNHA-SB","TNHA","SB","21181033",171,160,165.5,11
"539",2023-05-16,"TNHA-SC","TNHA","SC","21206909",329,55,192,274
"540",2023-05-16,"TNHA-SD","TNHA","SD","21398712",285,67,176,218
"541",2023-05-17,"BEO-BASE","BEO","BASE","21350855",241,125,183,116
"542",2023-05-17,"SSMH-SB","SSMH","SB","21206912",230,11,120.5,219
"543",2023-05-17,"TNHA-BASE","TNHA","BASE","21167037",298,174,236,124
"544",2023-05-17,"TNHA-SA","TNHA","SA","21398709",140,90,115,50
"545",2023-05-17,"TNHA-SB","TNHA","SB","21181033",163,159,161,4
"546",2023-05-17,"TNHA-SC","TNHA","SC","21206909",299,37,168,262
"547",2023-05-17,"TNHA-SD","TNHA","SD","21398712",358,7,182.5,351
"548",2023-05-18,"BEO-BASE","BEO","BASE","21350855",330,243,286.5,87
"549",2023-05-18,"SSMH-SB","SSMH","SB","21206912",358,1,179.5,357
"550",2023-05-18,"TNHA-BASE","TNHA","BASE","21167037",352,4,178,348
"551",2023-05-18,"TNHA-SA","TNHA","SA","21398709",310,107,208.5,203
"552",2023-05-18,"TNHA-SB","TNHA","SB","21181033",157,154,155.5,3
"553",2023-05-18,"TNHA-SC","TNHA","SC","21206909",348,4,176,344
"554",2023-05-18,"TNHA-SD","TNHA","SD","21398712",357,6,181.5,351
"555",2023-05-19,"BEO-BASE","BEO","BASE","21350855",336,264,300,72
"556",2023-05-19,"SSMH-SA","SSMH","SA","21206911",107,95,101,12
"557",2023-05-19,"SSMH-SB","SSMH","SB","21206912",358,3,180.5,355
"558",2023-05-19,"TNHA-BASE","TNHA","BASE","21167037",348,1,174.5,347
"559",2023-05-19,"TNHA-SA","TNHA","SA","21398709",312,105,208.5,207
"560",2023-05-19,"TNHA-SB","TNHA","SB","21181033",154,152,153,2
"561",2023-05-19,"TNHA-SC","TNHA","SC","21206909",320,90,205,230
"562",2023-05-19,"TNHA-SD","TNHA","SD","21398712",102,4,53,98
"563",2023-05-20,"BEO-BASE","BEO","BASE","21350855",350,267,308.5,83
"564",2023-05-20,"SSMH-SA","SSMH","SA","21206911",102,48,75,54
"565",2023-05-20,"SSMH-SB","SSMH","SB","21206912",358,1,179.5,357
"566",2023-05-20,"TNHA-BASE","TNHA","BASE","21167037",358,0,179,358
"567",2023-05-20,"TNHA-SA","TNHA","SA","21398709",320,129,224.5,191
"568",2023-05-20,"TNHA-SB","TNHA","SB","21181033",159,150,154.5,9
"569",2023-05-20,"TNHA-SC","TNHA","SC","21206909",316,79,197.5,237
"570",2023-05-20,"TNHA-SD","TNHA","SD","21398712",347,1,174,346
"571",2023-05-21,"BEO-BASE","BEO","BASE","21350855",348,222,285,126
"572",2023-05-21,"SSMH-SA","SSMH","SA","21206911",358,3,180.5,355
"573",2023-05-21,"SSMH-SB","SSMH","SB","21206912",358,1,179.5,357
"574",2023-05-21,"TNHA-BASE","TNHA","BASE","21167037",347,7,177,340
"575",2023-05-21,"TNHA-SA","TNHA","SA","21398709",309,114,211.5,195
"576",2023-05-21,"TNHA-SB","TNHA","SB","21181033",156,153,154.5,3
"577",2023-05-21,"TNHA-SC","TNHA","SC","21206909",305,70,187.5,235
"578",2023-05-21,"TNHA-SD","TNHA","SD","21398712",97,28,62.5,69
"579",2023-05-22,"BEO-BASE","BEO","BASE","21350855",337,205,271,132
"580",2023-05-22,"SSMH-SA","SSMH","SA","21206911",324,72,198,252
"581",2023-05-22,"SSMH-SB","SSMH","SB","21206912",358,1,179.5,357
"582",2023-05-22,"TNHA-BASE","TNHA","BASE","21167037",357,10,183.5,347
"583",2023-05-22,"TNHA-SA","TNHA","SA","21398709",316,110,213,206
"584",2023-05-22,"TNHA-SB","TNHA","SB","21181033",156,149,152.5,7
"585",2023-05-22,"TNHA-SC","TNHA","SC","21206909",319,38,178.5,281
"586",2023-05-22,"TNHA-SD","TNHA","SD","21398712",354,18,186,336
"587",2023-05-23,"BEO-BASE","BEO","BASE","21350855",354,0,177,354
"588",2023-05-23,"SSMH-SA","SSMH","SA","21206911",168,24,96,144
"589",2023-05-23,"SSMH-SB","SSMH","SB","21206912",358,1,179.5,357
"590",2023-05-23,"TNHA-BASE","TNHA","BASE","21167037",357,6,181.5,351
"591",2023-05-23,"TNHA-SA","TNHA","SA","21398709",334,84,209,250
"592",2023-05-23,"TNHA-SB","TNHA","SB","21181033",161,150,155.5,11
"593",2023-05-23,"TNHA-SC","TNHA","SC","21206909",355,8,181.5,347
"594",2023-05-23,"TNHA-SD","TNHA","SD","21398712",358,14,186,344
"595",2023-05-24,"BEO-BASE","BEO","BASE","21350855",145,74,109.5,71
"596",2023-05-24,"SSMH-SA","SSMH","SA","21206911",352,324,338,28
"597",2023-05-24,"SSMH-SB","SSMH","SB","21206912",222,65,143.5,157
"598",2023-05-24,"TNHA-BASE","TNHA","BASE","21167037",351,29,190,322
"599",2023-05-24,"TNHA-SA","TNHA","SA","21398709",133,97,115,36
"600",2023-05-24,"TNHA-SB","TNHA","SB","21181033",168,154,161,14
"601",2023-05-24,"TNHA-SC","TNHA","SC","21206909",111,94,102.5,17
"602",2023-05-24,"TNHA-SD","TNHA","SD","21398712",282,219,250.5,63
"603",2023-05-25,"BEO-BASE","BEO","BASE","21350855",175,135,155,40
"604",2023-05-25,"SSMH-SA","SSMH","SA","21206911",324,296,310,28
"605",2023-05-25,"SSMH-SB","SSMH","SB","21206912",220,21,120.5,199
"606",2023-05-25,"TNHA-BASE","TNHA","BASE","21167037",225,208,216.5,17
"607",2023-05-25,"TNHA-SA","TNHA","SA","21398709",131,110,120.5,21
"608",2023-05-25,"TNHA-SB","TNHA","SB","21181033",160,159,159.5,1
"609",2023-05-25,"TNHA-SC","TNHA","SC","21206909",247,104,175.5,143
"610",2023-05-25,"TNHA-SD","TNHA","SD","21398712",348,275,311.5,73
"611",2023-05-26,"BEO-BASE","BEO","BASE","21350855",174,112,143,62
"612",2023-05-26,"SSMH-SA","SSMH","SA","21206911",310,299,304.5,11
"613",2023-05-26,"SSMH-SB","SSMH","SB","21206912",241,72,156.5,169
"614",2023-05-26,"TNHA-BASE","TNHA","BASE","21167037",225,29,127,196
"615",2023-05-26,"TNHA-SA","TNHA","SA","21398709",135,114,124.5,21
"616",2023-05-26,"TNHA-SB","TNHA","SB","21181033",161,156,158.5,5
"617",2023-05-26,"TNHA-SC","TNHA","SC","21206909",206,102,154,104
"618",2023-05-26,"TNHA-SD","TNHA","SD","21398712",345,230,287.5,115
"619",2023-05-27,"BEO-BASE","BEO","BASE","21350855",132,90,111,42
"620",2023-05-27,"SSMH-SB","SSMH","SB","21206912",213,156,184.5,57
"621",2023-05-27,"TNHA-BASE","TNHA","BASE","21167037",202,18,110,184
"622",2023-05-27,"TNHA-SA","TNHA","SA","21398709",135,112,123.5,23
"623",2023-05-27,"TNHA-SB","TNHA","SB","21181033",164,154,159,10
"624",2023-05-27,"TNHA-SC","TNHA","SC","21206909",110,107,108.5,3
"625",2023-05-27,"TNHA-SD","TNHA","SD","21398712",265,227,246,38
"626",2023-05-28,"BEO-BASE","BEO","BASE","21350855",191,125,158,66
"627",2023-05-28,"SSMH-SA","SSMH","SA","21206911",317,302,309.5,15
"628",2023-05-28,"SSMH-SB","SSMH","SB","21206912",358,1,179.5,357
"629",2023-05-28,"TNHA-BASE","TNHA","BASE","21167037",239,51,145,188
"630",2023-05-28,"TNHA-SA","TNHA","SA","21398709",135,107,121,28
"631",2023-05-28,"TNHA-SB","TNHA","SB","21181033",154,152,153,2
"632",2023-05-28,"TNHA-SC","TNHA","SC","21206909",295,100,197.5,195
"633",2023-05-28,"TNHA-SD","TNHA","SD","21398712",358,253,305.5,105
"634",2023-05-29,"BEO-BASE","BEO","BASE","21350855",329,197,263,132
"635",2023-05-29,"SSMH-SB","SSMH","SB","21206912",357,4,180.5,353
"636",2023-05-29,"TNHA-BASE","TNHA","BASE","21167037",324,3,163.5,321
"637",2023-05-29,"TNHA-SA","TNHA","SA","21398709",307,115,211,192
"638",2023-05-29,"TNHA-SB","TNHA","SB","21181033",156,152,154,4
"639",2023-05-29,"TNHA-SC","TNHA","SC","21206909",348,8,178,340
"640",2023-05-29,"TNHA-SD","TNHA","SD","21398712",300,18,159,282
"641",2023-05-30,"BEO-BASE","BEO","BASE","21350855",344,7,175.5,337
"642",2023-05-30,"SSMH-SA","SSMH","SA","21206911",81,62,71.5,19
"643",2023-05-30,"SSMH-SB","SSMH","SB","21206912",358,0,179,358
"644",2023-05-30,"TNHA-BASE","TNHA","BASE","21167037",357,3,180,354
"645",2023-05-30,"TNHA-SA","TNHA","SA","21398709",314,17,165.5,297
"646",2023-05-30,"TNHA-SB","TNHA","SB","21181033",174,149,161.5,25
"647",2023-05-30,"TNHA-SC","TNHA","SC","21206909",333,4,168.5,329
"648",2023-05-30,"TNHA-SD","TNHA","SD","21398712",355,3,179,352
"649",2023-05-31,"BEO-BASE","BEO","BASE","21350855",354,0,177,354
"650",2023-05-31,"SSMH-SA","SSMH","SA","21206911",351,80,215.5,271
"651",2023-05-31,"SSMH-SB","SSMH","SB","21206912",357,10,183.5,347
"652",2023-05-31,"TNHA-BASE","TNHA","BASE","21167037",354,13,183.5,341
"653",2023-05-31,"TNHA-SA","TNHA","SA","21398709",319,53,186,266
"654",2023-05-31,"TNHA-SB","TNHA","SB","21181033",161,154,157.5,7
"655",2023-05-31,"TNHA-SC","TNHA","SC","21206909",323,86,204.5,237
"656",2023-05-31,"TNHA-SD","TNHA","SD","21398712",354,10,182,344
