"","Date","fullname","site","station","sensor","max","min","avg","amp"
"1",2022-09-01,"BEO-BASE","BEO","BASE","21350855",154,132,143,22
"2",2022-09-01,"SSMH-BASE","SSMH","BASE","21350820",292,253,272.5,39
"3",2022-09-01,"SSMH-SA","SSMH","SA","21206911",312,299,305.5,13
"4",2022-09-01,"SSMH-SB","SSMH","SB","21206912",338,77,207.5,261
"5",2022-09-01,"TNHA-BASE","TNHA","BASE","21167037",226,209,217.5,17
"6",2022-09-01,"TNHA-SA","TNHA","SA","21398709",153,125,139,28
"7",2022-09-01,"TNHA-SB","TNHA","SB","21398715",313,277,295,36
"8",2022-09-01,"TNHA-SC","TNHA","SC","21206909",126,114,120,12
"9",2022-09-01,"TNHA-SD","TNHA","SD","21398712",316,263,289.5,53
"10",2022-09-02,"BEO-BASE","BEO","BASE","21350855",133,66,99.5,67
"11",2022-09-02,"SSMH-BASE","SSMH","BASE","21350820",284,3,143.5,281
"12",2022-09-02,"SSMH-SA","SSMH","SA","21206911",358,1,179.5,357
"13",2022-09-02,"SSMH-SB","SSMH","SB","21206912",212,129,170.5,83
"14",2022-09-02,"TNHA-BASE","TNHA","BASE","21167037",358,0,179,358
"15",2022-09-02,"TNHA-SA","TNHA","SA","21398709",145,48,96.5,97
"16",2022-09-02,"TNHA-SB","TNHA","SB","21398715",292,268,280,24
"17",2022-09-02,"TNHA-SC","TNHA","SC","21206909",125,100,112.5,25
"18",2022-09-02,"TNHA-SD","TNHA","SD","21398712",270,219,244.5,51
"19",2022-09-03,"BEO-BASE","BEO","BASE","21350855",206,70,138,136
"20",2022-09-03,"SSMH-BASE","SSMH","BASE","21350820",344,15,179.5,329
"21",2022-09-03,"SSMH-SA","SSMH","SA","21206911",357,310,333.5,47
"22",2022-09-03,"SSMH-SB","SSMH","SB","21206912",161,91,126,70
"23",2022-09-03,"TNHA-BASE","TNHA","BASE","21167037",344,212,278,132
"24",2022-09-03,"TNHA-SA","TNHA","SA","21398709",129,86,107.5,43
"25",2022-09-03,"TNHA-SB","TNHA","SB","21398715",293,274,283.5,19
"26",2022-09-03,"TNHA-SC","TNHA","SC","21206909",330,13,171.5,317
"27",2022-09-03,"TNHA-SD","TNHA","SD","21398712",357,3,180,354
"28",2022-09-04,"BEO-BASE","BEO","BASE","21350855",358,0,179,358
"29",2022-09-04,"SSMH-BASE","SSMH","BASE","21350820",350,1,175.5,349
"30",2022-09-04,"SSMH-SA","SSMH","SA","21206911",350,6,178,344
"31",2022-09-04,"SSMH-SB","SSMH","SB","21206912",350,8,179,342
"32",2022-09-04,"TNHA-BASE","TNHA","BASE","21167037",347,4,175.5,343
"33",2022-09-04,"TNHA-SA","TNHA","SA","21398709",354,111,232.5,243
"34",2022-09-04,"TNHA-SB","TNHA","SB","21398715",323,253,288,70
"35",2022-09-04,"TNHA-SC","TNHA","SC","21206909",317,112,214.5,205
"36",2022-09-04,"TNHA-SD","TNHA","SD","21398712",358,3,180.5,355
"37",2022-09-05,"BEO-BASE","BEO","BASE","21350855",355,0,177.5,355
"38",2022-09-05,"SSMH-BASE","SSMH","BASE","21350820",352,6,179,346
"39",2022-09-05,"SSMH-SA","SSMH","SA","21206911",350,10,180,340
"40",2022-09-05,"SSMH-SB","SSMH","SB","21206912",358,3,180.5,355
"41",2022-09-05,"TNHA-BASE","TNHA","BASE","21167037",358,8,183,350
"42",2022-09-05,"TNHA-SA","TNHA","SA","21398709",333,101,217,232
"43",2022-09-05,"TNHA-SB","TNHA","SB","21398715",267,223,245,44
"44",2022-09-05,"TNHA-SC","TNHA","SC","21206909",331,59,195,272
"45",2022-09-05,"TNHA-SD","TNHA","SD","21398712",358,6,182,352
"46",2022-09-06,"BEO-BASE","BEO","BASE","21350855",213,170,191.5,43
"47",2022-09-06,"SSMH-BASE","SSMH","BASE","21350820",357,3,180,354
"48",2022-09-06,"SSMH-SA","SSMH","SA","21206911",319,306,312.5,13
"49",2022-09-06,"SSMH-SB","SSMH","SB","21206912",131,105,118,26
"50",2022-09-06,"TNHA-BASE","TNHA","BASE","21167037",313,223,268,90
"51",2022-09-06,"TNHA-SA","TNHA","SA","21398709",129,107,118,22
"52",2022-09-06,"TNHA-SB","TNHA","SB","21398715",270,241,255.5,29
"53",2022-09-06,"TNHA-SC","TNHA","SC","21206909",312,132,222,180
"54",2022-09-06,"TNHA-SD","TNHA","SD","21398712",358,1,179.5,357
"55",2022-09-07,"BEO-BASE","BEO","BASE","21350855",225,133,179,92
"56",2022-09-07,"SSMH-BASE","SSMH","BASE","21350820",305,7,156,298
"57",2022-09-07,"SSMH-SA","SSMH","SA","21206911",331,298,314.5,33
"58",2022-09-07,"SSMH-SB","SSMH","SB","21206912",194,88,141,106
"59",2022-09-07,"TNHA-BASE","TNHA","BASE","21167037",312,208,260,104
"60",2022-09-07,"TNHA-SA","TNHA","SA","21398709",132,98,115,34
"61",2022-09-07,"TNHA-SB","TNHA","SB","21398715",272,0,136,272
"62",2022-09-07,"TNHA-SC","TNHA","SC","21206909",358,104,231,254
"63",2022-09-07,"TNHA-SD","TNHA","SD","21398712",358,1,179.5,357
"64",2022-09-08,"BEO-BASE","BEO","BASE","21350855",184,145,164.5,39
"65",2022-09-08,"SSMH-BASE","SSMH","BASE","21350820",358,3,180.5,355
"66",2022-09-08,"SSMH-SA","SSMH","SA","21206911",316,305,310.5,11
"67",2022-09-08,"SSMH-SB","SSMH","SB","21206912",191,100,145.5,91
"68",2022-09-08,"TNHA-BASE","TNHA","BASE","21167037",234,209,221.5,25
"69",2022-09-08,"TNHA-SA","TNHA","SA","21398709",140,87,113.5,53
"70",2022-09-08,"TNHA-SB","TNHA","SB","21398715",272,28,150,244
"71",2022-09-08,"TNHA-SC","TNHA","SC","21206909",320,25,172.5,295
"72",2022-09-08,"TNHA-SD","TNHA","SD","21398712",358,3,180.5,355
"73",2022-09-09,"BEO-BASE","BEO","BASE","21350855",154,124,139,30
"74",2022-09-09,"SSMH-BASE","SSMH","BASE","21350820",292,195,243.5,97
"75",2022-09-09,"SSMH-SA","SSMH","SA","21206911",310,289,299.5,21
"76",2022-09-09,"SSMH-SB","SSMH","SB","21206912",258,175,216.5,83
"77",2022-09-09,"TNHA-BASE","TNHA","BASE","21167037",354,0,177,354
"78",2022-09-09,"TNHA-SA","TNHA","SA","21398709",136,118,127,18
"79",2022-09-09,"TNHA-SB","TNHA","SB","21398715",247,28,137.5,219
"80",2022-09-09,"TNHA-SC","TNHA","SC","21206909",125,118,121.5,7
"81",2022-09-09,"TNHA-SD","TNHA","SD","21398712",305,254,279.5,51
"82",2022-09-10,"BEO-BASE","BEO","BASE","21350855",150,129,139.5,21
"83",2022-09-10,"SSMH-BASE","SSMH","BASE","21350820",289,230,259.5,59
"84",2022-09-10,"SSMH-SA","SSMH","SA","21206911",312,298,305,14
"85",2022-09-10,"SSMH-SB","SSMH","SB","21206912",354,87,220.5,267
"86",2022-09-10,"TNHA-BASE","TNHA","BASE","21167037",329,208,268.5,121
"87",2022-09-10,"TNHA-SA","TNHA","SA","21398709",143,119,131,24
"88",2022-09-10,"TNHA-SB","TNHA","SB","21398715",236,149,192.5,87
"89",2022-09-10,"TNHA-SC","TNHA","SC","21206909",125,115,120,10
"90",2022-09-10,"TNHA-SD","TNHA","SD","21398712",314,257,285.5,57
"91",2022-09-11,"BEO-BASE","BEO","BASE","21350855",175,145,160,30
"92",2022-09-11,"SSMH-BASE","SSMH","BASE","21350820",284,267,275.5,17
"93",2022-09-11,"SSMH-SA","SSMH","SA","21206911",314,309,311.5,5
"94",2022-09-11,"SSMH-SB","SSMH","SB","21206912",243,60,151.5,183
"95",2022-09-11,"TNHA-BASE","TNHA","BASE","21167037",230,213,221.5,17
"96",2022-09-11,"TNHA-SA","TNHA","SA","21398709",145,118,131.5,27
"97",2022-09-11,"TNHA-SB","TNHA","SB","21398715",300,216,258,84
"98",2022-09-11,"TNHA-SC","TNHA","SC","21206909",292,104,198,188
"99",2022-09-11,"TNHA-SD","TNHA","SD","21398712",352,296,324,56
"100",2022-09-12,"BEO-BASE","BEO","BASE","21350855",157,135,146,22
"101",2022-09-12,"SSMH-BASE","SSMH","BASE","21350820",288,271,279.5,17
"102",2022-09-12,"SSMH-SA","SSMH","SA","21206911",313,305,309,8
"103",2022-09-12,"SSMH-SB","SSMH","SB","21206912",321,46,183.5,275
"104",2022-09-12,"TNHA-BASE","TNHA","BASE","21167037",218,209,213.5,9
"105",2022-09-12,"TNHA-SA","TNHA","SA","21398709",146,126,136,20
"106",2022-09-12,"TNHA-SB","TNHA","SB","21398715",319,225,272,94
"107",2022-09-12,"TNHA-SC","TNHA","SC","21206909",124,115,119.5,9
"108",2022-09-12,"TNHA-SD","TNHA","SD","21398712",314,288,301,26
"109",2022-09-13,"BEO-BASE","BEO","BASE","21350855",157,147,152,10
"110",2022-09-13,"SSMH-BASE","SSMH","BASE","21350820",282,271,276.5,11
"111",2022-09-13,"SSMH-SA","SSMH","SA","21206911",316,305,310.5,11
"112",2022-09-13,"SSMH-SB","SSMH","SB","21206912",358,1,179.5,357
"113",2022-09-13,"TNHA-BASE","TNHA","BASE","21167037",219,212,215.5,7
"114",2022-09-13,"TNHA-SA","TNHA","SA","21398709",173,129,151,44
"115",2022-09-13,"TNHA-SB","TNHA","SB","21398715",344,227,285.5,117
"116",2022-09-13,"TNHA-SC","TNHA","SC","21206909",122,112,117,10
"117",2022-09-13,"TNHA-SD","TNHA","SD","21398712",321,298,309.5,23
"118",2022-09-14,"BEO-BASE","BEO","BASE","21350855",153,143,148,10
"119",2022-09-14,"SSMH-BASE","SSMH","BASE","21350820",289,274,281.5,15
"120",2022-09-14,"SSMH-SA","SSMH","SA","21206911",314,306,310,8
"121",2022-09-14,"SSMH-SB","SSMH","SB","21206912",357,11,184,346
"122",2022-09-14,"TNHA-BASE","TNHA","BASE","21167037",216,212,214,4
"123",2022-09-14,"TNHA-SA","TNHA","SA","21398709",150,124,137,26
"124",2022-09-14,"TNHA-SB","TNHA","SB","21398715",334,199,266.5,135
"125",2022-09-14,"TNHA-SC","TNHA","SC","21206909",124,114,119,10
"126",2022-09-14,"TNHA-SD","TNHA","SD","21398712",310,292,301,18
"127",2022-09-15,"BEO-BASE","BEO","BASE","21350855",177,147,162,30
"128",2022-09-15,"SSMH-BASE","SSMH","BASE","21350820",299,260,279.5,39
"129",2022-09-15,"SSMH-SA","SSMH","SA","21206911",313,302,307.5,11
"130",2022-09-15,"SSMH-SB","SSMH","SB","21206912",358,22,190,336
"131",2022-09-15,"TNHA-BASE","TNHA","BASE","21167037",227,213,220,14
"132",2022-09-15,"TNHA-SA","TNHA","SA","21398709",153,131,142,22
"133",2022-09-15,"TNHA-SB","TNHA","SB","21398715",345,291,318,54
"134",2022-09-15,"TNHA-SC","TNHA","SC","21206909",299,111,205,188
"135",2022-09-15,"TNHA-SD","TNHA","SD","21398712",352,299,325.5,53
"136",2022-09-16,"BEO-BASE","BEO","BASE","21350855",180,166,173,14
"137",2022-09-16,"SSMH-BASE","SSMH","BASE","21350820",288,260,274,28
"138",2022-09-16,"SSMH-SA","SSMH","SA","21206911",312,303,307.5,9
"139",2022-09-16,"SSMH-SB","SSMH","SB","21206912",118,83,100.5,35
"140",2022-09-16,"TNHA-BASE","TNHA","BASE","21167037",230,223,226.5,7
"141",2022-09-16,"TNHA-SA","TNHA","SA","21398709",174,121,147.5,53
"142",2022-09-16,"TNHA-SB","TNHA","SB","21398715",344,299,321.5,45
"143",2022-09-16,"TNHA-SC","TNHA","SC","21206909",302,121,211.5,181
"144",2022-09-16,"TNHA-SD","TNHA","SD","21398712",354,341,347.5,13
"145",2022-09-17,"BEO-BASE","BEO","BASE","21350855",173,154,163.5,19
"146",2022-09-17,"SSMH-BASE","SSMH","BASE","21350820",324,256,290,68
"147",2022-09-17,"SSMH-SA","SSMH","SA","21206911",320,300,310,20
"148",2022-09-17,"SSMH-SB","SSMH","SB","21206912",358,49,203.5,309
"149",2022-09-17,"TNHA-BASE","TNHA","BASE","21167037",232,215,223.5,17
"150",2022-09-17,"TNHA-SA","TNHA","SA","21398709",188,131,159.5,57
"151",2022-09-17,"TNHA-SB","TNHA","SB","21398715",331,281,306,50
"152",2022-09-17,"TNHA-SC","TNHA","SC","21206909",302,104,203,198
"153",2022-09-17,"TNHA-SD","TNHA","SD","21398712",352,293,322.5,59
"154",2022-09-18,"BEO-BASE","BEO","BASE","21350855",181,153,167,28
"155",2022-09-18,"SSMH-BASE","SSMH","BASE","21350820",355,243,299,112
"156",2022-09-18,"SSMH-SA","SSMH","SA","21206911",317,303,310,14
"157",2022-09-18,"SSMH-SB","SSMH","SB","21206912",314,39,176.5,275
"158",2022-09-18,"TNHA-BASE","TNHA","BASE","21167037",232,215,223.5,17
"159",2022-09-18,"TNHA-SA","TNHA","SA","21398709",184,105,144.5,79
"160",2022-09-18,"TNHA-SB","TNHA","SB","21181033",333,7,170,326
"161",2022-09-18,"TNHA-SB","TNHA","SB","21398715",343,222,282.5,121
"162",2022-09-18,"TNHA-SC","TNHA","SC","21206909",358,62,210,296
"163",2022-09-18,"TNHA-SD","TNHA","SD","21398712",358,296,327,62
"164",2022-09-19,"BEO-BASE","BEO","BASE","21350855",279,156,217.5,123
"165",2022-09-19,"SSMH-BASE","SSMH","BASE","21350820",355,7,181,348
"166",2022-09-19,"SSMH-SA","SSMH","SA","21206911",358,1,179.5,357
"167",2022-09-19,"SSMH-SB","SSMH","SB","21206912",333,100,216.5,233
"168",2022-09-19,"TNHA-BASE","TNHA","BASE","21167037",350,216,283,134
"169",2022-09-19,"TNHA-SA","TNHA","SA","21398709",352,4,178,348
"170",2022-09-19,"TNHA-SB","TNHA","SB","21181033",267,42,154.5,225
"171",2022-09-19,"TNHA-SC","TNHA","SC","21206909",326,4,165,322
"172",2022-09-19,"TNHA-SD","TNHA","SD","21398712",358,1,179.5,357
"173",2022-09-20,"BEO-BASE","BEO","BASE","21350855",351,138,244.5,213
"174",2022-09-20,"SSMH-BASE","SSMH","BASE","21350820",357,0,178.5,357
"175",2022-09-20,"SSMH-SA","SSMH","SA","21206911",358,6,182,352
"176",2022-09-20,"SSMH-SB","SSMH","SB","21206912",358,0,179,358
"177",2022-09-20,"TNHA-BASE","TNHA","BASE","21167037",355,17,186,338
"178",2022-09-20,"TNHA-SA","TNHA","SA","21398709",295,95,195,200
"179",2022-09-20,"TNHA-SB","TNHA","SB","21181033",251,84,167.5,167
"180",2022-09-20,"TNHA-SC","TNHA","SC","21206909",329,35,182,294
"181",2022-09-20,"TNHA-SD","TNHA","SD","21398712",358,1,179.5,357
"182",2022-09-21,"BEO-BASE","BEO","BASE","21350855",341,226,283.5,115
"183",2022-09-21,"SSMH-BASE","SSMH","BASE","21350820",337,15,176,322
"184",2022-09-21,"SSMH-SA","SSMH","SA","21206911",358,1,179.5,357
"185",2022-09-21,"SSMH-SB","SSMH","SB","21206912",358,0,179,358
"186",2022-09-21,"TNHA-BASE","TNHA","BASE","21167037",355,3,179,352
"187",2022-09-21,"TNHA-SA","TNHA","SA","21398709",323,63,193,260
"188",2022-09-21,"TNHA-SB","TNHA","SB","21181033",330,27,178.5,303
"189",2022-09-21,"TNHA-SC","TNHA","SC","21206909",320,98,209,222
"190",2022-09-21,"TNHA-SD","TNHA","SD","21398712",128,3,65.5,125
"191",2022-09-22,"BEO-BASE","BEO","BASE","21350855",247,133,190,114
"192",2022-09-22,"SSMH-BASE","SSMH","BASE","21350820",292,13,152.5,279
"193",2022-09-22,"SSMH-SA","SSMH","SA","21206911",358,10,184,348
"194",2022-09-22,"SSMH-SB","SSMH","SB","21206912",227,35,131,192
"195",2022-09-22,"TNHA-BASE","TNHA","BASE","21167037",331,211,271,120
"196",2022-09-22,"TNHA-SA","TNHA","SA","21398709",146,87,116.5,59
"197",2022-09-22,"TNHA-SB","TNHA","SB","21181033",336,55,195.5,281
"198",2022-09-22,"TNHA-SC","TNHA","SC","21206909",351,49,200,302
"199",2022-09-22,"TNHA-SD","TNHA","SD","21398712",358,3,180.5,355
"200",2022-09-23,"BEO-BASE","BEO","BASE","21350855",152,93,122.5,59
"201",2022-09-23,"SSMH-BASE","SSMH","BASE","21350820",289,53,171,236
"202",2022-09-23,"SSMH-SA","SSMH","SA","21206911",334,302,318,32
"203",2022-09-23,"SSMH-SB","SSMH","SB","21206912",232,159,195.5,73
"204",2022-09-23,"TNHA-BASE","TNHA","BASE","21167037",355,0,177.5,355
"205",2022-09-23,"TNHA-SA","TNHA","SA","21398709",147,105,126,42
"206",2022-09-23,"TNHA-SB","TNHA","SB","21181033",343,38,190.5,305
"207",2022-09-23,"TNHA-SC","TNHA","SC","21206909",125,119,122,6
"208",2022-09-23,"TNHA-SD","TNHA","SD","21398712",305,220,262.5,85
"209",2022-09-24,"BEO-BASE","BEO","BASE","21350855",183,60,121.5,123
"210",2022-09-24,"SSMH-BASE","SSMH","BASE","21350820",355,28,191.5,327
"211",2022-09-24,"SSMH-SA","SSMH","SA","21206911",352,299,325.5,53
"212",2022-09-24,"SSMH-SB","SSMH","SB","21206912",275,4,139.5,271
"213",2022-09-24,"TNHA-BASE","TNHA","BASE","21167037",355,13,184,342
"214",2022-09-24,"TNHA-SA","TNHA","SA","21398709",161,98,129.5,63
"215",2022-09-24,"TNHA-SB","TNHA","SB","21181033",293,11,152,282
"216",2022-09-24,"TNHA-SC","TNHA","SC","21206909",347,1,174,346
"217",2022-09-24,"TNHA-SD","TNHA","SD","21398712",358,15,186.5,343
"218",2022-09-25,"BEO-BASE","BEO","BASE","21350855",160,118,139,42
"219",2022-09-25,"SSMH-BASE","SSMH","BASE","21350820",289,198,243.5,91
"220",2022-09-25,"SSMH-SA","SSMH","SA","21206911",317,300,308.5,17
"221",2022-09-25,"SSMH-SB","SSMH","SB","21206912",281,98,189.5,183
"222",2022-09-25,"TNHA-BASE","TNHA","BASE","21167037",351,0,175.5,351
"223",2022-09-25,"TNHA-SA","TNHA","SA","21398709",143,112,127.5,31
"224",2022-09-25,"TNHA-SB","TNHA","SB","21181033",358,35,196.5,323
"225",2022-09-25,"TNHA-SC","TNHA","SC","21206909",125,114,119.5,11
"226",2022-09-25,"TNHA-SD","TNHA","SD","21398712",310,241,275.5,69
"227",2022-09-26,"BEO-BASE","BEO","BASE","21350855",178,135,156.5,43
"228",2022-09-26,"SSMH-BASE","SSMH","BASE","21350820",286,253,269.5,33
"229",2022-09-26,"SSMH-SA","SSMH","SA","21206911",321,305,313,16
"230",2022-09-26,"SSMH-SB","SSMH","SB","21206912",279,81,180,198
"231",2022-09-26,"TNHA-BASE","TNHA","BASE","21167037",227,206,216.5,21
"232",2022-09-26,"TNHA-SA","TNHA","SA","21398709",152,100,126,52
"233",2022-09-26,"TNHA-SB","TNHA","SB","21181033",321,24,172.5,297
"234",2022-09-26,"TNHA-SC","TNHA","SC","21206909",291,97,194,194
"235",2022-09-26,"TNHA-SD","TNHA","SD","21398712",352,274,313,78
"236",2022-09-27,"BEO-BASE","BEO","BASE","21350855",194,133,163.5,61
"237",2022-09-27,"SSMH-BASE","SSMH","BASE","21350820",288,28,158,260
"238",2022-09-27,"SSMH-SA","SSMH","SA","21206911",327,303,315,24
"239",2022-09-27,"SSMH-SB","SSMH","SB","21206912",275,59,167,216
"240",2022-09-27,"TNHA-BASE","TNHA","BASE","21167037",302,211,256.5,91
"241",2022-09-27,"TNHA-SA","TNHA","SA","21398709",139,100,119.5,39
"242",2022-09-27,"TNHA-SB","TNHA","SB","21181033",317,76,196.5,241
"243",2022-09-27,"TNHA-SC","TNHA","SC","21206909",357,90,223.5,267
"244",2022-09-27,"TNHA-SD","TNHA","SD","21398712",354,11,182.5,343
"245",2022-09-28,"BEO-BASE","BEO","BASE","21350855",187,135,161,52
"246",2022-09-28,"SSMH-BASE","SSMH","BASE","21350820",351,20,185.5,331
"247",2022-09-28,"SSMH-SA","SSMH","SA","21206911",317,302,309.5,15
"248",2022-09-28,"SSMH-SB","SSMH","SB","21206912",128,95,111.5,33
"249",2022-09-28,"TNHA-BASE","TNHA","BASE","21167037",237,218,227.5,19
"250",2022-09-28,"TNHA-SA","TNHA","SA","21398709",139,101,120,38
"251",2022-09-28,"TNHA-SB","TNHA","SB","21181033",208,88,148,120
"252",2022-09-28,"TNHA-SC","TNHA","SC","21206909",293,98,195.5,195
"253",2022-09-28,"TNHA-SD","TNHA","SD","21398712",358,1,179.5,357
"254",2022-09-29,"BEO-BASE","BEO","BASE","21350855",170,114,142,56
"255",2022-09-29,"SSMH-BASE","SSMH","BASE","21350820",288,145,216.5,143
"256",2022-09-29,"SSMH-SA","SSMH","SA","21206911",323,302,312.5,21
"257",2022-09-29,"SSMH-SB","SSMH","SB","21206912",340,17,178.5,323
"258",2022-09-29,"TNHA-BASE","TNHA","BASE","21167037",355,7,181,348
"259",2022-09-29,"TNHA-SA","TNHA","SA","21398709",156,121,138.5,35
"260",2022-09-29,"TNHA-SB","TNHA","SB","21181033",358,59,208.5,299
"261",2022-09-29,"TNHA-SC","TNHA","SC","21206909",131,94,112.5,37
"262",2022-09-29,"TNHA-SD","TNHA","SD","21398712",348,236,292,112
"263",2022-09-30,"BEO-BASE","BEO","BASE","21350855",110,52,81,58
"264",2022-09-30,"SSMH-BASE","SSMH","BASE","21350820",355,13,184,342
"265",2022-09-30,"SSMH-SA","SSMH","SA","21206911",358,4,181,354
"266",2022-09-30,"SSMH-SB","SSMH","SB","21206912",173,122,147.5,51
"267",2022-09-30,"TNHA-BASE","TNHA","BASE","21167037",354,8,181,346
"268",2022-09-30,"TNHA-SA","TNHA","SA","21398709",354,13,183.5,341
"269",2022-09-30,"TNHA-SB","TNHA","SB","21181033",302,53,177.5,249
"270",2022-09-30,"TNHA-SC","TNHA","SC","21206909",107,15,61,92
"271",2022-09-30,"TNHA-SD","TNHA","SD","21398712",352,6,179,346
"272",2022-10-01,"BEO-BASE","BEO","BASE","21350855",153,59,106,94
"273",2022-10-01,"SSMH-BASE","SSMH","BASE","21350820",292,18,155,274
"274",2022-10-01,"SSMH-SA","SSMH","SA","21206911",355,8,181.5,347
"275",2022-10-01,"SSMH-SB","SSMH","SB","21206912",244,74,159,170
"276",2022-10-01,"TNHA-BASE","TNHA","BASE","21167037",358,1,179.5,357
"277",2022-10-01,"TNHA-SA","TNHA","SA","21398709",354,35,194.5,319
"278",2022-10-01,"TNHA-SB","TNHA","SB","21181033",344,27,185.5,317
"279",2022-10-01,"TNHA-SC","TNHA","SC","21206909",111,62,86.5,49
"280",2022-10-01,"TNHA-SD","TNHA","SD","21398712",344,24,184,320
"281",2022-10-02,"BEO-BASE","BEO","BASE","21350855",208,133,170.5,75
"282",2022-10-02,"SSMH-BASE","SSMH","BASE","21350820",285,1,143,284
"283",2022-10-02,"SSMH-SA","SSMH","SA","21206911",321,309,315,12
"284",2022-10-02,"SSMH-SB","SSMH","SB","21206912",199,52,125.5,147
"285",2022-10-02,"TNHA-BASE","TNHA","BASE","21167037",305,206,255.5,99
"286",2022-10-02,"TNHA-SA","TNHA","SA","21398709",135,95,115,40
"287",2022-10-02,"TNHA-SB","TNHA","SB","21181033",302,63,182.5,239
"288",2022-10-02,"TNHA-SC","TNHA","SC","21206909",338,35,186.5,303
"289",2022-10-02,"TNHA-SD","TNHA","SD","21398712",358,1,179.5,357
"290",2022-10-03,"BEO-BASE","BEO","BASE","21350855",218,177,197.5,41
"291",2022-10-03,"SSMH-BASE","SSMH","BASE","21350820",345,21,183,324
"292",2022-10-03,"SSMH-SA","SSMH","SA","21206911",319,307,313,12
"293",2022-10-03,"SSMH-SB","SSMH","SB","21206912",129,95,112,34
"294",2022-10-03,"TNHA-BASE","TNHA","BASE","21167037",316,230,273,86
"295",2022-10-03,"TNHA-SA","TNHA","SA","21398709",125,108,116.5,17
"296",2022-10-03,"TNHA-SB","TNHA","SB","21181033",220,206,213,14
"297",2022-10-03,"TNHA-SC","TNHA","SC","21206909",293,90,191.5,203
"298",2022-10-03,"TNHA-SD","TNHA","SD","21398712",358,1,179.5,357
"299",2022-10-04,"BEO-BASE","BEO","BASE","21350855",343,178,260.5,165
"300",2022-10-04,"SSMH-BASE","SSMH","BASE","21350820",302,25,163.5,277
"301",2022-10-04,"SSMH-SA","SSMH","SA","21206911",358,4,181,354
"302",2022-10-04,"SSMH-SB","SSMH","SB","21206912",358,0,179,358
"303",2022-10-04,"TNHA-BASE","TNHA","BASE","21167037",343,227,285,116
"304",2022-10-04,"TNHA-SA","TNHA","SA","21398709",358,104,231,254
"305",2022-10-04,"TNHA-SB","TNHA","SB","21181033",272,32,152,240
"306",2022-10-04,"TNHA-SC","TNHA","SC","21206909",300,25,162.5,275
"307",2022-10-04,"TNHA-SD","TNHA","SD","21398712",358,1,179.5,357
"308",2022-10-05,"BEO-BASE","BEO","BASE","21350855",337,192,264.5,145
"309",2022-10-05,"SSMH-BASE","SSMH","BASE","21350820",284,25,154.5,259
"310",2022-10-05,"SSMH-SA","SSMH","SA","21206911",329,6,167.5,323
"311",2022-10-05,"SSMH-SB","SSMH","SB","21206912",355,6,180.5,349
"312",2022-10-05,"TNHA-BASE","TNHA","BASE","21167037",347,6,176.5,341
"313",2022-10-05,"TNHA-SA","TNHA","SA","21398709",330,101,215.5,229
"314",2022-10-05,"TNHA-SB","TNHA","SB","21181033",323,143,233,180
"315",2022-10-05,"TNHA-SC","TNHA","SC","21206909",324,1,162.5,323
"316",2022-10-05,"TNHA-SD","TNHA","SD","21398712",358,1,179.5,357
"317",2022-10-06,"BEO-BASE","BEO","BASE","21350855",284,209,246.5,75
"318",2022-10-06,"SSMH-BASE","SSMH","BASE","21350820",326,29,177.5,297
"319",2022-10-06,"SSMH-SA","SSMH","SA","21206911",344,8,176,336
"320",2022-10-06,"SSMH-SB","SSMH","SB","21206912",309,100,204.5,209
"321",2022-10-06,"TNHA-BASE","TNHA","BASE","21167037",329,286,307.5,43
"322",2022-10-06,"TNHA-SA","TNHA","SA","21398709",309,105,207,204
"323",2022-10-06,"TNHA-SB","TNHA","SB","21181033",260,215,237.5,45
"324",2022-10-06,"TNHA-SC","TNHA","SC","21206909",303,94,198.5,209
"325",2022-10-06,"TNHA-SD","TNHA","SD","21398712",115,20,67.5,95
"326",2022-10-07,"BEO-BASE","BEO","BASE","21350855",302,240,271,62
"327",2022-10-07,"SSMH-BASE","SSMH","BASE","21350820",324,98,211,226
"328",2022-10-07,"SSMH-SA","SSMH","SA","21206911",107,1,54,106
"329",2022-10-07,"SSMH-SB","SSMH","SB","21206912",345,159,252,186
"330",2022-10-07,"TNHA-BASE","TNHA","BASE","21167037",326,230,278,96
"331",2022-10-07,"TNHA-SA","TNHA","SA","21398709",309,115,212,194
"332",2022-10-07,"TNHA-SB","TNHA","SB","21181033",284,227,255.5,57
"333",2022-10-07,"TNHA-SC","TNHA","SC","21206909",355,101,228,254
"334",2022-10-07,"TNHA-SD","TNHA","SD","21398712",223,31,127,192
"335",2022-10-08,"BEO-BASE","BEO","BASE","21350855",344,263,303.5,81
"336",2022-10-08,"SSMH-BASE","SSMH","BASE","21350820",292,152,222,140
"337",2022-10-08,"SSMH-SA","SSMH","SA","21206911",105,51,78,54
"338",2022-10-08,"SSMH-SB","SSMH","SB","21206912",358,3,180.5,355
"339",2022-10-08,"TNHA-BASE","TNHA","BASE","21167037",331,190,260.5,141
"340",2022-10-08,"TNHA-SA","TNHA","SA","21398709",338,20,179,318
"341",2022-10-08,"TNHA-SB","TNHA","SB","21181033",343,233,288,110
"342",2022-10-08,"TNHA-SC","TNHA","SC","21206909",317,104,210.5,213
"343",2022-10-08,"TNHA-SD","TNHA","SD","21398712",358,31,194.5,327
"344",2022-10-09,"BEO-BASE","BEO","BASE","21350855",355,15,185,340
"345",2022-10-09,"SSMH-BASE","SSMH","BASE","21350820",303,49,176,254
"346",2022-10-09,"SSMH-SA","SSMH","SA","21206911",358,3,180.5,355
"347",2022-10-09,"SSMH-SB","SSMH","SB","21206912",358,1,179.5,357
"348",2022-10-09,"TNHA-BASE","TNHA","BASE","21167037",358,4,181,354
"349",2022-10-09,"TNHA-SA","TNHA","SA","21398709",321,112,216.5,209
"350",2022-10-09,"TNHA-SB","TNHA","SB","21181033",357,11,184,346
"351",2022-10-09,"TNHA-SC","TNHA","SC","21206909",306,105,205.5,201
"352",2022-10-09,"TNHA-SD","TNHA","SD","21398712",108,22,65,86
"353",2022-10-10,"BEO-BASE","BEO","BASE","21350855",347,264,305.5,83
"354",2022-10-10,"SSMH-BASE","SSMH","BASE","21350820",296,42,169,254
"355",2022-10-10,"SSMH-SA","SSMH","SA","21206911",111,73,92,38
"356",2022-10-10,"SSMH-SB","SSMH","SB","21206912",357,3,180,354
"357",2022-10-10,"TNHA-BASE","TNHA","BASE","21167037",358,18,188,340
"358",2022-10-10,"TNHA-SA","TNHA","SA","21398709",329,72,200.5,257
"359",2022-10-10,"TNHA-SB","TNHA","SB","21181033",337,22,179.5,315
"360",2022-10-10,"TNHA-SC","TNHA","SC","21206909",307,76,191.5,231
"361",2022-10-10,"TNHA-SD","TNHA","SD","21398712",340,3,171.5,337
"362",2022-10-11,"BEO-BASE","BEO","BASE","21350855",309,271,290,38
"363",2022-10-11,"SSMH-BASE","SSMH","BASE","21350820",248,110,179,138
"364",2022-10-11,"SSMH-SA","SSMH","SA","21206911",107,76,91.5,31
"365",2022-10-11,"SSMH-SB","SSMH","SB","21206912",358,275,316.5,83
"366",2022-10-11,"TNHA-BASE","TNHA","BASE","21167037",334,226,280,108
"367",2022-10-11,"TNHA-SA","TNHA","SA","21398709",323,111,217,212
"368",2022-10-11,"TNHA-SB","TNHA","SB","21181033",331,248,289.5,83
"369",2022-10-11,"TNHA-SC","TNHA","SC","21206909",302,91,196.5,211
"370",2022-10-11,"TNHA-SD","TNHA","SD","21398712",286,51,168.5,235
"371",2022-10-12,"BEO-BASE","BEO","BASE","21350855",358,278,318,80
"372",2022-10-12,"SSMH-BASE","SSMH","BASE","21350820",320,11,165.5,309
"373",2022-10-12,"SSMH-SA","SSMH","SA","21206911",270,74,172,196
"374",2022-10-12,"SSMH-SB","SSMH","SB","21206912",358,3,180.5,355
"375",2022-10-12,"TNHA-BASE","TNHA","BASE","21167037",355,234,294.5,121
"376",2022-10-12,"TNHA-SA","TNHA","SA","21398709",348,218,283,130
"377",2022-10-12,"TNHA-SB","TNHA","SB","21181033",357,250,303.5,107
"378",2022-10-12,"TNHA-SC","TNHA","SC","21206909",316,48,182,268
"379",2022-10-12,"TNHA-SD","TNHA","SD","21398712",307,22,164.5,285
"380",2022-10-13,"BEO-BASE","BEO","BASE","21350855",358,0,179,358
"381",2022-10-13,"SSMH-BASE","SSMH","BASE","21350820",357,18,187.5,339
"382",2022-10-13,"SSMH-SA","SSMH","SA","21206911",357,4,180.5,353
"383",2022-10-13,"SSMH-SB","SSMH","SB","21206912",358,11,184.5,347
"384",2022-10-13,"TNHA-BASE","TNHA","BASE","21167037",347,1,174,346
"385",2022-10-13,"TNHA-SA","TNHA","SA","21398709",351,282,316.5,69
"386",2022-10-13,"TNHA-SB","TNHA","SB","21181033",358,1,179.5,357
"387",2022-10-13,"TNHA-SC","TNHA","SC","21206909",340,97,218.5,243
"388",2022-10-13,"TNHA-SD","TNHA","SD","21398712",341,24,182.5,317
"389",2022-10-14,"BEO-BASE","BEO","BASE","21350855",358,0,179,358
"390",2022-10-14,"SSMH-BASE","SSMH","BASE","21350820",340,1,170.5,339
"391",2022-10-14,"SSMH-SA","SSMH","SA","21206911",319,4,161.5,315
"392",2022-10-14,"SSMH-SB","SSMH","SB","21206912",104,7,55.5,97
"393",2022-10-14,"TNHA-BASE","TNHA","BASE","21167037",352,83,217.5,269
"394",2022-10-14,"TNHA-SA","TNHA","SA","21398709",348,295,321.5,53
"395",2022-10-14,"TNHA-SB","TNHA","SB","21181033",358,1,179.5,357
"396",2022-10-14,"TNHA-SC","TNHA","SC","21206909",312,293,302.5,19
"397",2022-10-14,"TNHA-SD","TNHA","SD","21398712",343,4,173.5,339
"398",2022-10-15,"BEO-BASE","BEO","BASE","21350855",344,216,280,128
"399",2022-10-15,"SSMH-BASE","SSMH","BASE","21350820",320,11,165.5,309
"400",2022-10-15,"SSMH-SA","SSMH","SA","21206911",333,4,168.5,329
"401",2022-10-15,"SSMH-SB","SSMH","SB","21206912",350,11,180.5,339
"402",2022-10-15,"TNHA-BASE","TNHA","BASE","21167037",347,22,184.5,325
"403",2022-10-15,"TNHA-SA","TNHA","SA","21398709",312,105,208.5,207
"404",2022-10-15,"TNHA-SB","TNHA","SB","21181033",334,213,273.5,121
"405",2022-10-15,"TNHA-SC","TNHA","SC","21206909",357,80,218.5,277
"406",2022-10-15,"TNHA-SD","TNHA","SD","21398712",111,18,64.5,93
"407",2022-10-16,"BEO-BASE","BEO","BASE","21350855",216,135,175.5,81
"408",2022-10-16,"SSMH-BASE","SSMH","BASE","21350820",302,60,181,242
"409",2022-10-16,"SSMH-SA","SSMH","SA","21206911",327,292,309.5,35
"410",2022-10-16,"SSMH-SB","SSMH","SB","21206912",340,51,195.5,289
"411",2022-10-16,"TNHA-BASE","TNHA","BASE","21167037",314,211,262.5,103
"412",2022-10-16,"TNHA-SA","TNHA","SA","21398709",152,104,128,48
"413",2022-10-16,"TNHA-SB","TNHA","SB","21181033",219,11,115,208
"414",2022-10-16,"TNHA-SC","TNHA","SC","21206909",298,73,185.5,225
"415",2022-10-16,"TNHA-SD","TNHA","SD","21398712",357,4,180.5,353
"416",2022-10-17,"BEO-BASE","BEO","BASE","21350855",152,117,134.5,35
"417",2022-10-17,"SSMH-BASE","SSMH","BASE","21350820",288,163,225.5,125
"418",2022-10-17,"SSMH-SA","SSMH","SA","21206911",329,292,310.5,37
"419",2022-10-17,"SSMH-SB","SSMH","SB","21206912",330,22,176,308
"420",2022-10-17,"TNHA-BASE","TNHA","BASE","21167037",352,10,181,342
"421",2022-10-17,"TNHA-SA","TNHA","SA","21398709",149,119,134,30
"422",2022-10-17,"TNHA-SB","TNHA","SB","21181033",350,3,176.5,347
"423",2022-10-17,"TNHA-SC","TNHA","SC","21206909",111,100,105.5,11
"424",2022-10-17,"TNHA-SD","TNHA","SD","21398712",306,237,271.5,69
"425",2022-10-18,"BEO-BASE","BEO","BASE","21350855",190,107,148.5,83
"426",2022-10-18,"SSMH-BASE","SSMH","BASE","21350820",302,17,159.5,285
"427",2022-10-18,"SSMH-SA","SSMH","SA","21206911",330,305,317.5,25
"428",2022-10-18,"SSMH-SB","SSMH","SB","21206912",202,97,149.5,105
"429",2022-10-18,"TNHA-BASE","TNHA","BASE","21167037",357,7,182,350
"430",2022-10-18,"TNHA-SA","TNHA","SA","21398709",161,101,131,60
"431",2022-10-18,"TNHA-SB","TNHA","SB","21181033",314,29,171.5,285
"432",2022-10-18,"TNHA-SC","TNHA","SC","21206909",292,83,187.5,209
"433",2022-10-18,"TNHA-SD","TNHA","SD","21398712",358,3,180.5,355
"434",2022-10-19,"BEO-BASE","BEO","BASE","21350855",295,174,234.5,121
"435",2022-10-19,"SSMH-BASE","SSMH","BASE","21350820",309,11,160,298
"436",2022-10-19,"SSMH-SA","SSMH","SA","21206911",327,4,165.5,323
"437",2022-10-19,"SSMH-SB","SSMH","SB","21206912",333,4,168.5,329
"438",2022-10-19,"TNHA-BASE","TNHA","BASE","21167037",347,6,176.5,341
"439",2022-10-19,"TNHA-SA","TNHA","SA","21398709",293,104,198.5,189
"440",2022-10-19,"TNHA-SB","TNHA","SB","21181033",257,199,228,58
"441",2022-10-19,"TNHA-SC","TNHA","SC","21206909",293,102,197.5,191
"442",2022-10-19,"TNHA-SD","TNHA","SD","21398712",358,1,179.5,357
"443",2022-10-20,"BEO-BASE","BEO","BASE","21350855",174,126,150,48
"444",2022-10-20,"SSMH-BASE","SSMH","BASE","21350820",316,256,286,60
"445",2022-10-20,"SSMH-SA","SSMH","SA","21206911",324,305,314.5,19
"446",2022-10-20,"SSMH-SB","SSMH","SB","21206912",257,31,144,226
"447",2022-10-20,"TNHA-BASE","TNHA","BASE","21167037",236,208,222,28
"448",2022-10-20,"TNHA-SA","TNHA","SA","21398709",171,110,140.5,61
"449",2022-10-20,"TNHA-SB","TNHA","SB","21181033",184,58,121,126
"450",2022-10-20,"TNHA-SC","TNHA","SC","21206909",334,76,205,258
"451",2022-10-20,"TNHA-SD","TNHA","SD","21398712",357,274,315.5,83
"452",2022-10-21,"BEO-BASE","BEO","BASE","21350855",180,163,171.5,17
"453",2022-10-21,"SSMH-BASE","SSMH","BASE","21350820",319,24,171.5,295
"454",2022-10-21,"SSMH-SA","SSMH","SA","21206911",312,298,305,14
"455",2022-10-21,"SSMH-SB","SSMH","SB","21206912",114,74,94,40
"456",2022-10-21,"TNHA-BASE","TNHA","BASE","21167037",229,222,225.5,7
"457",2022-10-21,"TNHA-SA","TNHA","SA","21398709",156,119,137.5,37
"458",2022-10-21,"TNHA-SB","TNHA","SB","21181033",208,52,130,156
"459",2022-10-21,"TNHA-SC","TNHA","SC","21206909",288,98,193,190
"460",2022-10-21,"TNHA-SD","TNHA","SD","21398712",348,333,340.5,15
"461",2022-10-22,"BEO-BASE","BEO","BASE","21350855",185,174,179.5,11
"462",2022-10-22,"SSMH-BASE","SSMH","BASE","21350820",345,21,183,324
"463",2022-10-22,"SSMH-SA","SSMH","SA","21206911",312,300,306,12
"464",2022-10-22,"SSMH-SB","SSMH","SB","21206912",117,91,104,26
"465",2022-10-22,"TNHA-BASE","TNHA","BASE","21167037",233,222,227.5,11
"466",2022-10-22,"TNHA-SA","TNHA","SA","21398709",147,111,129,36
"467",2022-10-22,"TNHA-SB","TNHA","SB","21181033",211,53,132,158
"468",2022-10-22,"TNHA-SC","TNHA","SC","21206909",289,227,258,62
"469",2022-10-22,"TNHA-SD","TNHA","SD","21398712",358,343,350.5,15
"470",2022-10-23,"BEO-BASE","BEO","BASE","21350855",205,175,190,30
"471",2022-10-23,"SSMH-BASE","SSMH","BASE","21350820",327,1,164,326
"472",2022-10-23,"SSMH-SA","SSMH","SA","21206911",319,302,310.5,17
"473",2022-10-23,"SSMH-SB","SSMH","SB","21206912",128,102,115,26
"474",2022-10-23,"TNHA-BASE","TNHA","BASE","21167037",321,223,272,98
"475",2022-10-23,"TNHA-SA","TNHA","SA","21398709",135,108,121.5,27
"476",2022-10-23,"TNHA-SB","TNHA","SB","21181033",216,195,205.5,21
"477",2022-10-23,"TNHA-SC","TNHA","SC","21206909",292,277,284.5,15
"478",2022-10-23,"TNHA-SD","TNHA","SD","21398712",358,1,179.5,357
"479",2022-10-24,"BEO-BASE","BEO","BASE","21350855",195,175,185,20
"480",2022-10-24,"SSMH-BASE","SSMH","BASE","21350820",331,8,169.5,323
"481",2022-10-24,"SSMH-SA","SSMH","SA","21206911",319,302,310.5,17
"482",2022-10-24,"SSMH-SB","SSMH","SB","21206912",129,107,118,22
"483",2022-10-24,"TNHA-BASE","TNHA","BASE","21167037",244,223,233.5,21
"484",2022-10-24,"TNHA-SA","TNHA","SA","21398709",126,107,116.5,19
"485",2022-10-24,"TNHA-SB","TNHA","SB","21181033",215,197,206,18
"486",2022-10-24,"TNHA-SC","TNHA","SC","21206909",289,281,285,8
"487",2022-10-24,"TNHA-SD","TNHA","SD","21398712",358,1,179.5,357
"488",2022-10-25,"BEO-BASE","BEO","BASE","21350855",194,181,187.5,13
"489",2022-10-25,"SSMH-BASE","SSMH","BASE","21350820",331,1,166,330
"490",2022-10-25,"SSMH-SA","SSMH","SA","21206911",319,299,309,20
"491",2022-10-25,"SSMH-SB","SSMH","SB","21206912",126,112,119,14
"492",2022-10-25,"TNHA-BASE","TNHA","BASE","21167037",240,227,233.5,13
"493",2022-10-25,"TNHA-SA","TNHA","SA","21398709",125,108,116.5,17
"494",2022-10-25,"TNHA-SB","TNHA","SB","21181033",213,204,208.5,9
"495",2022-10-25,"TNHA-SC","TNHA","SC","21206909",289,285,287,4
"496",2022-10-25,"TNHA-SD","TNHA","SD","21398712",358,1,179.5,357
"497",2022-10-26,"BEO-BASE","BEO","BASE","21350855",188,32,110,156
"498",2022-10-26,"SSMH-BASE","SSMH","BASE","21350820",293,25,159,268
"499",2022-10-26,"SSMH-SA","SSMH","SA","21206911",338,302,320,36
"500",2022-10-26,"SSMH-SB","SSMH","SB","21206912",271,81,176,190
"501",2022-10-26,"TNHA-BASE","TNHA","BASE","21167037",357,1,179,356
"502",2022-10-26,"TNHA-SA","TNHA","SA","21398709",147,98,122.5,49
"503",2022-10-26,"TNHA-SB","TNHA","SB","21181033",351,31,191,320
"504",2022-10-26,"TNHA-SC","TNHA","SC","21206909",286,93,189.5,193
"505",2022-10-26,"TNHA-SD","TNHA","SD","21398712",358,219,288.5,139
"506",2022-10-27,"BEO-BASE","BEO","BASE","21350855",201,108,154.5,93
"507",2022-10-27,"SSMH-BASE","SSMH","BASE","21350820",343,35,189,308
"508",2022-10-27,"SSMH-SA","SSMH","SA","21206911",334,298,316,36
"509",2022-10-27,"SSMH-SB","SSMH","SB","21206912",317,32,174.5,285
"510",2022-10-27,"TNHA-BASE","TNHA","BASE","21167037",278,4,141,274
"511",2022-10-27,"TNHA-SA","TNHA","SA","21398709",170,108,139,62
"512",2022-10-27,"TNHA-SB","TNHA","SB","21181033",341,8,174.5,333
"513",2022-10-27,"TNHA-SC","TNHA","SC","21206909",299,94,196.5,205
"514",2022-10-27,"TNHA-SD","TNHA","SD","21398712",355,3,179,352
"515",2022-10-28,"BEO-BASE","BEO","BASE","21350855",188,140,164,48
"516",2022-10-28,"SSMH-BASE","SSMH","BASE","21350820",357,38,197.5,319
"517",2022-10-28,"SSMH-SA","SSMH","SA","21206911",319,299,309,20
"518",2022-10-28,"SSMH-SB","SSMH","SB","21206912",331,38,184.5,293
"519",2022-10-28,"TNHA-BASE","TNHA","BASE","21167037",263,211,237,52
"520",2022-10-28,"TNHA-SA","TNHA","SA","21398709",171,97,134,74
"521",2022-10-28,"TNHA-SB","TNHA","SB","21181033",213,49,131,164
"522",2022-10-28,"TNHA-SC","TNHA","SC","21206909",314,88,201,226
"523",2022-10-28,"TNHA-SD","TNHA","SD","21398712",358,18,188,340
"524",2022-10-29,"BEO-BASE","BEO","BASE","21350855",164,105,134.5,59
"525",2022-10-29,"SSMH-BASE","SSMH","BASE","21350820",307,154,230.5,153
"526",2022-10-29,"SSMH-SA","SSMH","SA","21206911",324,302,313,22
"527",2022-10-29,"SSMH-SB","SSMH","SB","21206912",355,18,186.5,337
"528",2022-10-29,"TNHA-BASE","TNHA","BASE","21167037",225,7,116,218
"529",2022-10-29,"TNHA-SA","TNHA","SA","21398709",178,100,139,78
"530",2022-10-29,"TNHA-SB","TNHA","SB","21181033",307,44,175.5,263
"531",2022-10-29,"TNHA-SC","TNHA","SC","21206909",112,51,81.5,61
"532",2022-10-29,"TNHA-SD","TNHA","SD","21398712",337,237,287,100
"533",2022-10-30,"BEO-BASE","BEO","BASE","21350855",223,139,181,84
"534",2022-10-30,"SSMH-BASE","SSMH","BASE","21350820",358,11,184.5,347
"535",2022-10-30,"SSMH-SA","SSMH","SA","21206911",314,296,305,18
"536",2022-10-30,"SSMH-SB","SSMH","SB","21206912",343,4,173.5,339
"537",2022-10-30,"TNHA-BASE","TNHA","BASE","21167037",312,209,260.5,103
"538",2022-10-30,"TNHA-SA","TNHA","SA","21398709",183,91,137,92
"539",2022-10-30,"TNHA-SB","TNHA","SB","21181033",206,39,122.5,167
"540",2022-10-30,"TNHA-SC","TNHA","SC","21206909",292,24,158,268
"541",2022-10-30,"TNHA-SD","TNHA","SD","21398712",358,1,179.5,357
"542",2022-10-31,"BEO-BASE","BEO","BASE","21350855",211,160,185.5,51
"543",2022-10-31,"SSMH-BASE","SSMH","BASE","21350820",316,1,158.5,315
"544",2022-10-31,"SSMH-SA","SSMH","SA","21206911",319,302,310.5,17
"545",2022-10-31,"SSMH-SB","SSMH","SB","21206912",136,72,104,64
"546",2022-10-31,"TNHA-BASE","TNHA","BASE","21167037",317,223,270,94
"547",2022-10-31,"TNHA-SA","TNHA","SA","21398709",139,100,119.5,39
"548",2022-10-31,"TNHA-SB","TNHA","SB","21181033",216,102,159,114
"549",2022-10-31,"TNHA-SC","TNHA","SC","21206909",293,97,195,196
"550",2022-10-31,"TNHA-SD","TNHA","SD","21398712",358,1,179.5,357
"551",2022-11-01,"BEO-BASE","BEO","BASE","21350855",264,190,227,74
"552",2022-11-01,"SSMH-BASE","SSMH","BASE","21350820",333,24,178.5,309
"553",2022-11-01,"SSMH-SA","SSMH","SA","21206911",358,3,180.5,355
"554",2022-11-01,"SSMH-SB","SSMH","SB","21206912",183,42,112.5,141
"555",2022-11-01,"TNHA-BASE","TNHA","BASE","21167037",337,284,310.5,53
"556",2022-11-01,"TNHA-SA","TNHA","SA","21398709",131,107,119,24
"557",2022-11-01,"TNHA-SB","TNHA","SB","21181033",241,211,226,30
"558",2022-11-01,"TNHA-SC","TNHA","SC","21206909",298,65,181.5,233
"559",2022-11-01,"TNHA-SD","TNHA","SD","21398712",100,11,55.5,89
"560",2022-11-02,"BEO-BASE","BEO","BASE","21350855",258,63,160.5,195
"561",2022-11-02,"SSMH-BASE","SSMH","BASE","21350820",357,6,181.5,351
"562",2022-11-02,"SSMH-SA","SSMH","SA","21206911",358,3,180.5,355
"563",2022-11-02,"SSMH-SB","SSMH","SB","21206912",181,48,114.5,133
"564",2022-11-02,"TNHA-BASE","TNHA","BASE","21167037",357,225,291,132
"565",2022-11-02,"TNHA-SA","TNHA","SA","21398709",128,4,66,124
"566",2022-11-02,"TNHA-SB","TNHA","SB","21181033",240,55,147.5,185
"567",2022-11-02,"TNHA-SC","TNHA","SC","21206909",341,18,179.5,323
"568",2022-11-02,"TNHA-SD","TNHA","SD","21398712",250,0,125,250
"569",2022-11-03,"BEO-BASE","BEO","BASE","21350855",288,74,181,214
"570",2022-11-03,"SSMH-BASE","SSMH","BASE","21350820",320,24,172,296
"571",2022-11-03,"SSMH-SA","SSMH","SA","21206911",333,56,194.5,277
"572",2022-11-03,"SSMH-SB","SSMH","SB","21206912",216,55,135.5,161
"573",2022-11-03,"TNHA-BASE","TNHA","BASE","21167037",358,205,281.5,153
"574",2022-11-03,"TNHA-SA","TNHA","SA","21398709",175,108,141.5,67
"575",2022-11-03,"TNHA-SB","TNHA","SB","21181033",256,31,143.5,225
"576",2022-11-03,"TNHA-SC","TNHA","SC","21206909",312,70,191,242
"577",2022-11-03,"TNHA-SD","TNHA","SD","21398712",358,6,182,352
"578",2022-11-04,"BEO-BASE","BEO","BASE","21350855",190,124,157,66
"579",2022-11-04,"SSMH-BASE","SSMH","BASE","21350820",313,67,190,246
"580",2022-11-04,"SSMH-SA","SSMH","SA","21206911",345,10,177.5,335
"581",2022-11-04,"SSMH-SB","SSMH","SB","21206912",275,20,147.5,255
"582",2022-11-04,"TNHA-BASE","TNHA","BASE","21167037",240,205,222.5,35
"583",2022-11-04,"TNHA-SA","TNHA","SA","21398709",167,95,131,72
"584",2022-11-04,"TNHA-SB","TNHA","SB","21181033",344,17,180.5,327
"585",2022-11-04,"TNHA-SC","TNHA","SC","21206909",324,84,204,240
"586",2022-11-04,"TNHA-SD","TNHA","SD","21398712",358,24,191,334
"587",2022-11-05,"BEO-BASE","BEO","BASE","21350855",291,107,199,184
"588",2022-11-05,"SSMH-BASE","SSMH","BASE","21350820",286,41,163.5,245
"589",2022-11-05,"SSMH-SA","SSMH","SA","21206911",358,22,190,336
"590",2022-11-05,"SSMH-SB","SSMH","SB","21206912",233,1,117,232
"591",2022-11-05,"TNHA-BASE","TNHA","BASE","21167037",351,8,179.5,343
"592",2022-11-05,"TNHA-SA","TNHA","SA","21398709",159,107,133,52
"593",2022-11-05,"TNHA-SB","TNHA","SB","21181033",327,28,177.5,299
"594",2022-11-05,"TNHA-SC","TNHA","SC","21206909",330,3,166.5,327
"595",2022-11-05,"TNHA-SD","TNHA","SD","21398712",354,18,186,336
"596",2022-11-06,"BEO-BASE","BEO","BASE","21350855",272,198,235,74
"597",2022-11-06,"SSMH-BASE","SSMH","BASE","21350820",347,32,189.5,315
"598",2022-11-06,"SSMH-SA","SSMH","SA","21206911",354,29,191.5,325
"599",2022-11-06,"SSMH-SB","SSMH","SB","21206912",124,27,75.5,97
"600",2022-11-06,"TNHA-BASE","TNHA","BASE","21167037",337,293,315,44
"601",2022-11-06,"TNHA-SA","TNHA","SA","21398709",264,102,183,162
"602",2022-11-06,"TNHA-SB","TNHA","SB","21181033",253,212,232.5,41
"603",2022-11-06,"TNHA-SC","TNHA","SC","21206909",292,100,196,192
"604",2022-11-06,"TNHA-SD","TNHA","SD","21398712",107,7,57,100
"605",2022-11-07,"BEO-BASE","BEO","BASE","21350855",305,168,236.5,137
"606",2022-11-07,"SSMH-BASE","SSMH","BASE","21350820",317,28,172.5,289
"607",2022-11-07,"SSMH-SA","SSMH","SA","21206911",347,15,181,332
"608",2022-11-07,"SSMH-SB","SSMH","SB","21206912",334,6,170,328
"609",2022-11-07,"TNHA-BASE","TNHA","BASE","21167037",338,223,280.5,115
"610",2022-11-07,"TNHA-SA","TNHA","SA","21398709",300,110,205,190
"611",2022-11-07,"TNHA-SB","TNHA","SB","21181033",274,98,186,176
"612",2022-11-07,"TNHA-SC","TNHA","SC","21206909",293,100,196.5,193
"613",2022-11-07,"TNHA-SD","TNHA","SD","21398712",357,11,184,346
"614",2022-11-08,"BEO-BASE","BEO","BASE","21350855",264,167,215.5,97
"615",2022-11-08,"SSMH-BASE","SSMH","BASE","21350820",327,31,179,296
"616",2022-11-08,"SSMH-SA","SSMH","SA","21206911",323,21,172,302
"617",2022-11-08,"SSMH-SB","SSMH","SB","21206912",194,86,140,108
"618",2022-11-08,"TNHA-BASE","TNHA","BASE","21167037",327,223,275,104
"619",2022-11-08,"TNHA-SA","TNHA","SA","21398709",156,108,132,48
"620",2022-11-08,"TNHA-SB","TNHA","SB","21181033",243,59,151,184
"621",2022-11-08,"TNHA-SC","TNHA","SC","21206909",291,98,194.5,193
"622",2022-11-08,"TNHA-SD","TNHA","SD","21398712",358,1,179.5,357
"623",2022-11-09,"BEO-BASE","BEO","BASE","21350855",295,195,245,100
"624",2022-11-09,"SSMH-BASE","SSMH","BASE","21350820",338,35,186.5,303
"625",2022-11-09,"SSMH-SA","SSMH","SA","21206911",358,13,185.5,345
"626",2022-11-09,"SSMH-SB","SSMH","SB","21206912",354,37,195.5,317
"627",2022-11-09,"TNHA-BASE","TNHA","BASE","21167037",340,286,313,54
"628",2022-11-09,"TNHA-SA","TNHA","SA","21398709",285,108,196.5,177
"629",2022-11-09,"TNHA-SB","TNHA","SB","21181033",264,205,234.5,59
"630",2022-11-09,"TNHA-SC","TNHA","SC","21206909",291,100,195.5,191
"631",2022-11-09,"TNHA-SD","TNHA","SD","21398712",119,11,65,108
"632",2022-11-10,"BEO-BASE","BEO","BASE","21350855",313,247,280,66
"633",2022-11-10,"SSMH-BASE","SSMH","BASE","21350820",296,146,221,150
"634",2022-11-10,"SSMH-SA","SSMH","SA","21206911",105,20,62.5,85
"635",2022-11-10,"SSMH-SB","SSMH","SB","21206912",358,14,186,344
"636",2022-11-10,"TNHA-BASE","TNHA","BASE","21167037",331,232,281.5,99
"637",2022-11-10,"TNHA-SA","TNHA","SA","21398709",351,104,227.5,247
"638",2022-11-10,"TNHA-SB","TNHA","SB","21181033",289,234,261.5,55
"639",2022-11-10,"TNHA-SC","TNHA","SC","21206909",309,100,204.5,209
"640",2022-11-10,"TNHA-SD","TNHA","SD","21398712",307,35,171,272
"641",2022-11-11,"BEO-BASE","BEO","BASE","21350855",291,202,246.5,89
"642",2022-11-11,"SSMH-BASE","SSMH","BASE","21350820",355,32,193.5,323
"643",2022-11-11,"SSMH-SA","SSMH","SA","21206911",355,14,184.5,341
"644",2022-11-11,"SSMH-SB","SSMH","SB","21206912",321,11,166,310
"645",2022-11-11,"TNHA-BASE","TNHA","BASE","21167037",331,268,299.5,63
"646",2022-11-11,"TNHA-SA","TNHA","SA","21398709",300,69,184.5,231
"647",2022-11-11,"TNHA-SB","TNHA","SB","21181033",271,208,239.5,63
"648",2022-11-11,"TNHA-SC","TNHA","SC","21206909",296,56,176,240
"649",2022-11-11,"TNHA-SD","TNHA","SD","21398712",112,14,63,98
"650",2022-11-12,"BEO-BASE","BEO","BASE","21350855",358,211,284.5,147
"651",2022-11-12,"SSMH-BASE","SSMH","BASE","21350820",347,1,174,346
"652",2022-11-12,"SSMH-SA","SSMH","SA","21206911",354,4,179,350
"653",2022-11-12,"SSMH-SB","SSMH","SB","21206912",357,0,178.5,357
"654",2022-11-12,"TNHA-BASE","TNHA","BASE","21167037",357,284,320.5,73
"655",2022-11-12,"TNHA-SA","TNHA","SA","21398709",236,108,172,128
"656",2022-11-12,"TNHA-SB","TNHA","SB","21181033",251,181,216,70
"657",2022-11-12,"TNHA-SC","TNHA","SC","21206909",336,6,171,330
"658",2022-11-12,"TNHA-SD","TNHA","SD","21398712",352,6,179,346
"659",2022-11-13,"BEO-BASE","BEO","BASE","21350855",306,13,159.5,293
"660",2022-11-13,"SSMH-BASE","SSMH","BASE","21350820",350,1,175.5,349
"661",2022-11-13,"SSMH-SA","SSMH","SA","21206911",358,1,179.5,357
"662",2022-11-13,"SSMH-SB","SSMH","SB","21206912",358,114,236,244
"663",2022-11-13,"TNHA-BASE","TNHA","BASE","21167037",341,310,325.5,31
"664",2022-11-13,"TNHA-SA","TNHA","SA","21398709",344,3,173.5,341
"665",2022-11-13,"TNHA-SB","TNHA","SB","21181033",248,56,152,192
"666",2022-11-13,"TNHA-SC","TNHA","SC","21206909",357,10,183.5,347
"667",2022-11-13,"TNHA-SD","TNHA","SD","21398712",358,1,179.5,357
"668",2022-11-14,"BEO-BASE","BEO","BASE","21350855",296,8,152,288
"669",2022-11-14,"SSMH-BASE","SSMH","BASE","21350820",295,44,169.5,251
"670",2022-11-14,"SSMH-SA","SSMH","SA","21206911",358,3,180.5,355
"671",2022-11-14,"SSMH-SB","SSMH","SB","21206912",358,11,184.5,347
"672",2022-11-14,"TNHA-BASE","TNHA","BASE","21167037",338,299,318.5,39
"673",2022-11-14,"TNHA-SA","TNHA","SA","21398709",334,7,170.5,327
"674",2022-11-14,"TNHA-SB","TNHA","SB","21181033",257,60,158.5,197
"675",2022-11-14,"TNHA-SC","TNHA","SC","21206909",114,49,81.5,65
"676",2022-11-14,"TNHA-SD","TNHA","SD","21398712",156,41,98.5,115
"677",2022-11-15,"BEO-BASE","BEO","BASE","21350855",299,247,273,52
"678",2022-11-15,"SSMH-BASE","SSMH","BASE","21350820",316,115,215.5,201
"679",2022-11-15,"SSMH-SA","SSMH","SA","21206911",108,21,64.5,87
"680",2022-11-15,"SSMH-SB","SSMH","SB","21206912",358,8,183,350
"681",2022-11-15,"TNHA-BASE","TNHA","BASE","21167037",333,246,289.5,87
"682",2022-11-15,"TNHA-SA","TNHA","SA","21398709",305,111,208,194
"683",2022-11-15,"TNHA-SB","TNHA","SB","21181033",270,229,249.5,41
"684",2022-11-15,"TNHA-SC","TNHA","SC","21206909",114,101,107.5,13
"685",2022-11-15,"TNHA-SD","TNHA","SD","21398712",121,44,82.5,77
"686",2022-11-16,"BEO-BASE","BEO","BASE","21350855",281,237,259,44
"687",2022-11-16,"SSMH-BASE","SSMH","BASE","21350820",351,156,253.5,195
"688",2022-11-16,"SSMH-SA","SSMH","SA","21206911",358,1,179.5,357
"689",2022-11-16,"SSMH-SB","SSMH","SB","21206912",344,13,178.5,331
"690",2022-11-16,"TNHA-BASE","TNHA","BASE","21167037",330,289,309.5,41
"691",2022-11-16,"TNHA-SA","TNHA","SA","21398709",329,65,197,264
"692",2022-11-16,"TNHA-SB","TNHA","SB","21181033",254,219,236.5,35
"693",2022-11-16,"TNHA-SC","TNHA","SC","21206909",124,100,112,24
"694",2022-11-16,"TNHA-SD","TNHA","SD","21398712",124,13,68.5,111
"695",2022-11-17,"BEO-BASE","BEO","BASE","21350855",291,251,271,40
"696",2022-11-17,"SSMH-BASE","SSMH","BASE","21350820",309,161,235,148
"697",2022-11-17,"SSMH-SA","SSMH","SA","21206911",101,14,57.5,87
"698",2022-11-17,"SSMH-SB","SSMH","SB","21206912",351,4,177.5,347
"699",2022-11-17,"TNHA-BASE","TNHA","BASE","21167037",331,299,315,32
"700",2022-11-17,"TNHA-SA","TNHA","SA","21398709",317,108,212.5,209
"701",2022-11-17,"TNHA-SB","TNHA","SB","21181033",264,229,246.5,35
"702",2022-11-17,"TNHA-SC","TNHA","SC","21206909",112,104,108,8
"703",2022-11-17,"TNHA-SD","TNHA","SD","21398712",121,45,83,76
"704",2022-11-18,"BEO-BASE","BEO","BASE","21350855",312,237,274.5,75
"705",2022-11-18,"SSMH-BASE","SSMH","BASE","21350820",319,107,213,212
"706",2022-11-18,"SSMH-SA","SSMH","SA","21206911",358,6,182,352
"707",2022-11-18,"SSMH-SB","SSMH","SB","21206912",352,4,178,348
"708",2022-11-18,"TNHA-BASE","TNHA","BASE","21167037",330,185,257.5,145
"709",2022-11-18,"TNHA-SA","TNHA","SA","21398709",313,20,166.5,293
"710",2022-11-18,"TNHA-SB","TNHA","SB","21181033",292,220,256,72
"711",2022-11-18,"TNHA-SC","TNHA","SC","21206909",300,91,195.5,209
"712",2022-11-18,"TNHA-SD","TNHA","SD","21398712",274,14,144,260
"713",2022-11-19,"BEO-BASE","BEO","BASE","21350855",345,275,310,70
"714",2022-11-19,"SSMH-BASE","SSMH","BASE","21350820",293,178,235.5,115
"715",2022-11-19,"SSMH-SA","SSMH","SA","21206911",98,66,82,32
"716",2022-11-19,"SSMH-SB","SSMH","SB","21206912",358,1,179.5,357
"717",2022-11-19,"TNHA-BASE","TNHA","BASE","21167037",348,7,177.5,341
"718",2022-11-19,"TNHA-SA","TNHA","SA","21398709",343,114,228.5,229
"719",2022-11-19,"TNHA-SB","TNHA","SB","21181033",337,248,292.5,89
"720",2022-11-19,"TNHA-SC","TNHA","SC","21206909",310,108,209,202
"721",2022-11-19,"TNHA-SD","TNHA","SD","21398712",357,7,182,350
"722",2022-11-20,"BEO-BASE","BEO","BASE","21350855",286,67,176.5,219
"723",2022-11-20,"SSMH-BASE","SSMH","BASE","21350820",354,7,180.5,347
"724",2022-11-20,"SSMH-SA","SSMH","SA","21206911",358,6,182,352
"725",2022-11-20,"SSMH-SB","SSMH","SB","21206912",352,3,177.5,349
"726",2022-11-20,"TNHA-BASE","TNHA","BASE","21167037",357,7,182,350
"727",2022-11-20,"TNHA-SA","TNHA","SA","21398709",345,58,201.5,287
"728",2022-11-20,"TNHA-SB","TNHA","SB","21181033",338,60,199,278
"729",2022-11-20,"TNHA-SC","TNHA","SC","21206909",114,72,93,42
"730",2022-11-20,"TNHA-SD","TNHA","SD","21398712",333,104,218.5,229
"731",2022-11-21,"BEO-BASE","BEO","BASE","21350855",173,95,134,78
"732",2022-11-21,"SSMH-BASE","SSMH","BASE","21350820",292,67,179.5,225
"733",2022-11-21,"SSMH-SA","SSMH","SA","21206911",340,284,312,56
"734",2022-11-21,"SSMH-SB","SSMH","SB","21206912",331,22,176.5,309
"735",2022-11-21,"TNHA-BASE","TNHA","BASE","21167037",357,0,178.5,357
"736",2022-11-21,"TNHA-SA","TNHA","SA","21398709",188,102,145,86
"737",2022-11-21,"TNHA-SB","TNHA","SB","21181033",352,6,179,346
"738",2022-11-21,"TNHA-SC","TNHA","SC","21206909",112,98,105,14
"739",2022-11-21,"TNHA-SD","TNHA","SD","21398712",330,220,275,110
"740",2022-11-22,"BEO-BASE","BEO","BASE","21350855",136,118,127,18
"741",2022-11-22,"SSMH-BASE","SSMH","BASE","21350820",271,185,228,86
"742",2022-11-22,"SSMH-SA","SSMH","SA","21206911",302,296,299,6
"743",2022-11-22,"SSMH-SB","SSMH","SB","21206912",233,191,212,42
"744",2022-11-22,"TNHA-BASE","TNHA","BASE","21167037",345,10,177.5,335
"745",2022-11-22,"TNHA-SA","TNHA","SA","21398709",142,124,133,18
"746",2022-11-22,"TNHA-SB","TNHA","SB","21181033",320,277,298.5,43
"747",2022-11-22,"TNHA-SC","TNHA","SC","21206909",111,107,109,4
"748",2022-11-22,"TNHA-SD","TNHA","SD","21398712",271,237,254,34
"749",2022-11-23,"BEO-BASE","BEO","BASE","21350855",211,112,161.5,99
"750",2022-11-23,"SSMH-BASE","SSMH","BASE","21350820",286,3,144.5,283
"751",2022-11-23,"SSMH-SB","SSMH","SB","21206912",260,83,171.5,177
"752",2022-11-23,"TNHA-BASE","TNHA","BASE","21167037",340,0,170,340
"753",2022-11-23,"TNHA-SA","TNHA","SA","21398709",145,110,127.5,35
"754",2022-11-23,"TNHA-SB","TNHA","SB","21181033",321,49,185,272
"755",2022-11-23,"TNHA-SC","TNHA","SC","21206909",291,100,195.5,191
"756",2022-11-23,"TNHA-SD","TNHA","SD","21398712",330,4,167,326
"757",2022-11-24,"BEO-BASE","BEO","BASE","21350855",194,81,137.5,113
"758",2022-11-24,"SSMH-BASE","SSMH","BASE","21350820",354,1,177.5,353
"759",2022-11-24,"SSMH-SB","SSMH","SB","21206912",239,83,161,156
"760",2022-11-24,"TNHA-BASE","TNHA","BASE","21167037",355,13,184,342
"761",2022-11-24,"TNHA-SA","TNHA","SA","21398709",145,98,121.5,47
"762",2022-11-24,"TNHA-SB","TNHA","SB","21181033",314,7,160.5,307
"763",2022-11-24,"TNHA-SC","TNHA","SC","21206909",338,87,212.5,251
"764",2022-11-24,"TNHA-SD","TNHA","SD","21398712",358,1,179.5,357
"765",2022-11-25,"BEO-BASE","BEO","BASE","21350855",188,97,142.5,91
"766",2022-11-25,"SSMH-BASE","SSMH","BASE","21350820",282,17,149.5,265
"767",2022-11-25,"SSMH-SB","SSMH","SB","21206912",256,114,185,142
"768",2022-11-25,"TNHA-BASE","TNHA","BASE","21167037",351,1,176,350
"769",2022-11-25,"TNHA-SA","TNHA","SA","21398709",142,104,123,38
"770",2022-11-25,"TNHA-SB","TNHA","SB","21181033",358,22,190,336
"771",2022-11-25,"TNHA-SC","TNHA","SC","21206909",293,58,175.5,235
"772",2022-11-25,"TNHA-SD","TNHA","SD","21398712",336,14,175,322
"773",2022-11-26,"BEO-BASE","BEO","BASE","21350855",206,98,152,108
"774",2022-11-26,"SSMH-BASE","SSMH","BASE","21350820",350,37,193.5,313
"775",2022-11-26,"SSMH-SA","SSMH","SA","21206911",321,303,312,18
"776",2022-11-26,"SSMH-SB","SSMH","SB","21206912",260,65,162.5,195
"777",2022-11-26,"TNHA-BASE","TNHA","BASE","21167037",357,4,180.5,353
"778",2022-11-26,"TNHA-SA","TNHA","SA","21398709",154,98,126,56
"779",2022-11-26,"TNHA-SB","TNHA","SB","21181033",312,4,158,308
"780",2022-11-26,"TNHA-SC","TNHA","SC","21206909",298,76,187,222
"781",2022-11-26,"TNHA-SD","TNHA","SD","21398712",351,7,179,344
"782",2022-11-27,"BEO-BASE","BEO","BASE","21350855",295,208,251.5,87
"783",2022-11-27,"SSMH-BASE","SSMH","BASE","21350820",331,65,198,266
"784",2022-11-27,"SSMH-SA","SSMH","SA","21206911",348,8,178,340
"785",2022-11-27,"SSMH-SB","SSMH","SB","21206912",358,10,184,348
"786",2022-11-27,"TNHA-BASE","TNHA","BASE","21167037",352,307,329.5,45
"787",2022-11-27,"TNHA-SA","TNHA","SA","21398709",240,108,174,132
"788",2022-11-27,"TNHA-SB","TNHA","SB","21181033",256,218,237,38
"789",2022-11-27,"TNHA-SC","TNHA","SC","21206909",296,98,197,198
"790",2022-11-27,"TNHA-SD","TNHA","SD","21398712",110,32,71,78
"791",2022-11-28,"BEO-BASE","BEO","BASE","21350855",281,240,260.5,41
"792",2022-11-28,"SSMH-BASE","SSMH","BASE","21350820",324,164,244,160
"793",2022-11-28,"SSMH-SA","SSMH","SA","21206911",355,6,180.5,349
"794",2022-11-28,"SSMH-SB","SSMH","SB","21206912",341,15,178,326
"795",2022-11-28,"TNHA-BASE","TNHA","BASE","21167037",334,298,316,36
"796",2022-11-28,"TNHA-SA","TNHA","SA","21398709",285,111,198,174
"797",2022-11-28,"TNHA-SB","TNHA","SB","21181033",260,225,242.5,35
"798",2022-11-28,"TNHA-SC","TNHA","SC","21206909",147,97,122,50
"799",2022-11-28,"TNHA-SD","TNHA","SD","21398712",114,28,71,86
"800",2022-11-29,"BEO-BASE","BEO","BASE","21350855",302,240,271,62
"801",2022-11-29,"SSMH-BASE","SSMH","BASE","21350820",330,136,233,194
"802",2022-11-29,"SSMH-SA","SSMH","SA","21206911",358,20,189,338
"803",2022-11-29,"SSMH-SB","SSMH","SB","21206912",358,6,182,352
"804",2022-11-29,"TNHA-BASE","TNHA","BASE","21167037",334,236,285,98
"805",2022-11-29,"TNHA-SA","TNHA","SA","21398709",291,112,201.5,179
"806",2022-11-29,"TNHA-SB","TNHA","SB","21181033",272,225,248.5,47
"807",2022-11-29,"TNHA-SC","TNHA","SC","21206909",118,84,101,34
"808",2022-11-29,"TNHA-SD","TNHA","SD","21398712",117,18,67.5,99
"809",2022-11-30,"BEO-BASE","BEO","BASE","21350855",344,8,176,336
"810",2022-11-30,"SSMH-BASE","SSMH","BASE","21350820",337,35,186,302
"811",2022-11-30,"SSMH-SA","SSMH","SA","21206911",110,39,74.5,71
"812",2022-11-30,"SSMH-SB","SSMH","SB","21206912",357,1,179,356
"813",2022-11-30,"TNHA-BASE","TNHA","BASE","21167037",351,17,184,334
"814",2022-11-30,"TNHA-SA","TNHA","SA","21398709",326,124,225,202
"815",2022-11-30,"TNHA-SB","TNHA","SB","21181033",327,35,181,292
"816",2022-11-30,"TNHA-SC","TNHA","SC","21206909",357,102,229.5,255
"817",2022-11-30,"TNHA-SD","TNHA","SD","21398712",233,48,140.5,185
